Ward,Precinct,Registered,Votes,RAHM EMANUEL ,%,JESUS ''CHUY'' GARCIA ,%
1,1,753,259,93,0.3591,166,0.6409
1,2,706,254,75,0.2953,179,0.7047
1,3,811,269,149,0.5539,120,0.4461
1,4,790,277,145,0.5235,132,0.4765
1,5,784,217,144,0.6636,73,0.3364
1,6,748,290,144,0.4966,146,0.5034
1,7,462,186,79,0.4247,107,0.5753
1,8,716,269,158,0.5874,111,0.4126
1,9,543,264,106,0.4015,158,0.5985
1,10,797,226,138,0.6106,88,0.3894
1,11,755,253,149,0.5889,104,0.4111
1,12,877,300,139,0.4633,161,0.5367
1,13,346,121,40,0.3306,81,0.6694
1,14,713,270,147,0.5444,123,0.4556
1,15,685,256,85,0.332,171,0.668
1,16,546,228,64,0.2807,164,0.7193
1,17,676,251,83,0.3307,168,0.6693
1,18,779,289,104,0.3599,185,0.6401
1,19,911,388,126,0.3247,262,0.6753
1,20,638,238,72,0.3025,166,0.6975
1,21,783,232,154,0.6638,78,0.3362
1,22,513,167,68,0.4072,99,0.5928
1,23,962,395,155,0.3924,240,0.6076
1,24,725,200,55,0.275,145,0.725
1,25,730,201,77,0.3831,124,0.6169
1,26,644,198,39,0.197,159,0.803
1,27,765,247,118,0.4777,129,0.5223
1,28,330,133,51,0.3835,82,0.6165
1,29,684,257,139,0.5409,118,0.4591
1,30,828,310,83,0.2677,227,0.7323
1,31,764,279,123,0.4409,156,0.5591
1,32,686,264,138,0.5227,126,0.4773
1,33,820,282,140,0.4965,142,0.5035
1,34,609,235,86,0.366,149,0.634
1,35,797,299,145,0.4849,154,0.5151
1,36,708,232,150,0.6466,82,0.3534
1,37,697,241,132,0.5477,109,0.4523
1,38,676,271,109,0.4022,162,0.5978
1,39,694,236,107,0.4534,129,0.5466
1,40,719,281,165,0.5872,116,0.4128
1,41,444,192,72,0.375,120,0.625
1,42,228,91,29,0.3187,62,0.6813
1,43,507,183,86,0.4699,97,0.5301
1,44,558,196,87,0.4439,109,0.5561
2,1,798,251,137,0.5458,114,0.4542
2,2,568,344,299,0.8692,45,0.1308
2,3,764,276,176,0.6377,100,0.3623
2,4,726,268,141,0.5261,127,0.4739
2,5,824,313,168,0.5367,145,0.4633
2,6,782,269,132,0.4907,137,0.5093
2,7,951,282,170,0.6028,112,0.3972
2,8,816,287,148,0.5157,139,0.4843
2,9,700,271,229,0.845,42,0.155
2,10,686,369,334,0.9051,35,0.0949
2,11,637,377,344,0.9125,33,0.0875
2,12,725,336,258,0.7679,78,0.2321
2,13,648,398,336,0.8442,62,0.1558
2,14,754,343,172,0.5015,171,0.4985
2,15,715,276,174,0.6304,102,0.3696
2,16,722,219,148,0.6758,71,0.3242
2,17,860,351,218,0.6211,133,0.3789
2,18,606,289,246,0.8512,43,0.1488
2,19,547,305,274,0.8984,31,0.1016
2,20,874,271,234,0.8635,37,0.1365
2,21,745,315,186,0.5905,129,0.4095
2,22,749,379,319,0.8417,60,0.1583
2,23,543,337,310,0.9199,27,0.0801
2,24,708,296,252,0.8514,44,0.1486
2,25,745,268,186,0.694,82,0.306
2,26,731,246,190,0.7724,56,0.2276
2,27,653,299,256,0.8562,43,0.1438
2,28,811,344,273,0.7936,71,0.2064
2,29,789,292,248,0.8493,44,0.1507
2,30,657,293,238,0.8123,55,0.1877
2,31,954,484,425,0.8781,59,0.1219
2,32,632,235,193,0.8213,42,0.1787
2,33,952,532,446,0.8383,86,0.1617
2,34,574,343,309,0.9009,34,0.0991
2,35,913,281,237,0.8434,44,0.1566
2,36,573,278,228,0.8201,50,0.1799
2,37,626,363,282,0.7769,81,0.2231
2,38,683,376,322,0.8564,54,0.1436
2,39,579,251,207,0.8247,44,0.1753
2,40,775,252,211,0.8373,41,0.1627
2,41,755,210,181,0.8619,29,0.1381
2,42,745,279,210,0.7527,69,0.2473
2,43,805,355,301,0.8479,54,0.1521
2,44,430,232,190,0.819,42,0.181
2,45,774,342,238,0.6959,104,0.3041
2,46,462,187,155,0.8289,32,0.1711
3,1,1061,345,198,0.5739,147,0.4261
3,2,772,448,307,0.6853,141,0.3147
3,3,809,343,241,0.7026,102,0.2974
3,4,806,351,177,0.5043,174,0.4957
3,5,711,223,147,0.6592,76,0.3408
3,6,820,346,261,0.7543,85,0.2457
3,7,625,279,155,0.5556,124,0.4444
3,8,811,229,134,0.5852,95,0.4148
3,9,743,304,175,0.5757,129,0.4243
3,10,657,158,94,0.5949,64,0.4051
3,11,789,304,171,0.5625,133,0.4375
3,12,733,365,211,0.5781,154,0.4219
3,13,792,369,277,0.7507,92,0.2493
3,14,710,260,183,0.7038,77,0.2962
3,15,765,283,156,0.5512,127,0.4488
3,16,843,291,179,0.6151,112,0.3849
3,17,822,309,204,0.6602,105,0.3398
3,18,1207,432,264,0.6111,168,0.3889
3,19,743,337,253,0.7507,84,0.2493
3,20,862,318,182,0.5723,136,0.4277
3,21,814,402,293,0.7289,109,0.2711
3,22,841,296,204,0.6892,92,0.3108
3,23,785,291,177,0.6082,114,0.3918
3,24,795,291,188,0.646,103,0.354
3,25,958,458,372,0.8122,86,0.1878
3,26,788,450,358,0.7956,92,0.2044
3,27,794,313,222,0.7093,91,0.2907
3,28,661,267,194,0.7266,73,0.2734
3,29,972,312,200,0.641,112,0.359
3,30,788,324,193,0.5957,131,0.4043
3,31,873,361,237,0.6565,124,0.3435
3,32,820,344,265,0.7703,79,0.2297
3,33,836,256,190,0.7422,66,0.2578
3,34,860,360,256,0.7111,104,0.2889
3,35,566,163,85,0.5215,78,0.4785
3,36,657,174,100,0.5747,74,0.4253
3,37,751,254,148,0.5827,106,0.4173
3,38,650,350,249,0.7114,101,0.2886
3,39,781,302,250,0.8278,52,0.1722
3,40,840,367,225,0.6131,142,0.3869
3,41,769,290,182,0.6276,108,0.3724
4,1,819,399,138,0.3459,261,0.6541
4,2,763,376,295,0.7846,81,0.2154
4,3,809,305,172,0.5639,133,0.4361
4,4,1005,412,227,0.551,185,0.449
4,5,742,342,178,0.5205,164,0.4795
4,6,904,488,307,0.6291,181,0.3709
4,7,852,410,234,0.5707,176,0.4293
4,8,830,416,221,0.5313,195,0.4688
4,9,810,485,251,0.5175,234,0.4825
4,10,857,398,225,0.5653,173,0.4347
4,11,898,340,221,0.65,119,0.35
4,12,870,351,193,0.5499,158,0.4501
4,13,613,192,130,0.6771,62,0.3229
4,14,767,353,199,0.5637,154,0.4363
4,15,899,400,240,0.6,160,0.4
4,16,840,347,254,0.732,93,0.268
4,17,754,341,235,0.6891,106,0.3109
4,18,781,362,221,0.6105,141,0.3895
4,19,935,312,180,0.5769,132,0.4231
4,20,675,346,242,0.6994,104,0.3006
4,21,882,304,195,0.6414,109,0.3586
4,22,778,403,237,0.5881,166,0.4119
4,23,916,461,238,0.5163,223,0.4837
4,24,778,337,205,0.6083,132,0.3917
4,25,730,340,253,0.7441,87,0.2559
4,26,829,377,227,0.6021,150,0.3979
4,27,813,355,137,0.3859,218,0.6141
4,28,704,356,214,0.6011,142,0.3989
4,29,782,269,141,0.5242,128,0.4758
4,30,1087,386,230,0.5959,156,0.4041
4,31,661,457,287,0.628,170,0.372
4,32,851,331,185,0.5589,146,0.4411
4,33,836,393,207,0.5267,186,0.4733
4,34,710,280,154,0.55,126,0.45
4,35,983,457,273,0.5974,184,0.4026
4,36,857,395,223,0.5646,172,0.4354
4,37,747,324,233,0.7191,91,0.2809
4,38,788,397,242,0.6096,155,0.3904
5,1,785,271,166,0.6125,105,0.3875
5,2,794,259,133,0.5135,126,0.4865
5,3,663,343,130,0.379,213,0.621
5,4,799,316,163,0.5158,153,0.4842
5,5,792,328,173,0.5274,155,0.4726
5,6,732,268,139,0.5187,129,0.4813
5,7,609,309,194,0.6278,115,0.3722
5,8,648,369,202,0.5474,167,0.4526
5,9,782,398,233,0.5854,165,0.4146
5,10,766,261,143,0.5479,118,0.4521
5,11,679,379,181,0.4776,198,0.5224
5,12,800,227,134,0.5903,93,0.4097
5,13,742,270,153,0.5667,117,0.4333
5,14,600,316,186,0.5886,130,0.4114
5,15,657,323,171,0.5294,152,0.4706
5,16,872,314,191,0.6083,123,0.3917
5,17,816,256,163,0.6367,93,0.3633
5,18,587,299,154,0.5151,145,0.4849
5,19,668,374,157,0.4198,217,0.5802
5,20,742,387,209,0.5401,178,0.4599
5,21,677,307,138,0.4495,169,0.5505
5,22,678,439,311,0.7084,128,0.2916
5,23,1010,493,275,0.5578,218,0.4422
5,24,728,322,143,0.4441,179,0.5559
5,25,772,339,184,0.5428,155,0.4572
5,26,757,311,178,0.5723,133,0.4277
5,27,624,292,153,0.524,139,0.476
5,28,790,386,226,0.5855,160,0.4145
5,29,871,376,179,0.4761,197,0.5239
5,30,801,230,117,0.5087,113,0.4913
5,31,744,229,121,0.5284,108,0.4716
5,32,752,410,234,0.5707,176,0.4293
5,33,825,355,214,0.6028,141,0.3972
5,34,748,404,245,0.6064,159,0.3936
5,35,651,365,196,0.537,169,0.463
5,36,684,246,145,0.5894,101,0.4106
5,37,708,387,233,0.6021,154,0.3979
5,38,825,281,162,0.5765,119,0.4235
5,39,585,307,173,0.5635,134,0.4365
5,40,684,303,171,0.5644,132,0.4356
5,41,331,227,149,0.6564,78,0.3436
6,1,709,350,202,0.5771,148,0.4229
6,2,702,321,192,0.5981,129,0.4019
6,3,661,333,235,0.7057,98,0.2943
6,4,646,220,133,0.6045,87,0.3955
6,5,776,217,120,0.553,97,0.447
6,6,665,285,164,0.5754,121,0.4246
6,7,725,264,160,0.6061,104,0.3939
6,8,657,321,176,0.5483,145,0.4517
6,9,835,254,141,0.5551,113,0.4449
6,10,677,186,108,0.5806,78,0.4194
6,11,759,243,135,0.5556,108,0.4444
6,12,773,176,101,0.5739,75,0.4261
6,13,597,227,121,0.533,106,0.467
6,14,769,282,156,0.5532,126,0.4468
6,15,932,247,138,0.5587,109,0.4413
6,16,701,337,185,0.549,152,0.451
6,17,713,213,141,0.662,72,0.338
6,18,677,200,118,0.59,82,0.41
6,19,697,280,183,0.6536,97,0.3464
6,20,676,159,88,0.5535,71,0.4465
6,21,670,173,107,0.6185,66,0.3815
6,22,687,203,111,0.5468,92,0.4532
6,23,708,174,97,0.5575,77,0.4425
6,24,637,165,104,0.6303,61,0.3697
6,25,692,174,95,0.546,79,0.454
6,26,785,170,90,0.5294,80,0.4706
6,27,693,160,74,0.4625,86,0.5375
6,28,680,147,79,0.5374,68,0.4626
6,29,679,351,198,0.5641,153,0.4359
6,30,794,239,121,0.5063,118,0.4937
6,31,664,321,191,0.595,130,0.405
6,32,700,272,155,0.5699,117,0.4301
6,33,731,302,167,0.553,135,0.447
6,34,676,303,170,0.5611,133,0.4389
6,35,638,296,166,0.5608,130,0.4392
6,36,667,341,203,0.5953,138,0.4047
6,37,656,373,187,0.5013,186,0.4987
6,38,704,340,172,0.5059,168,0.4941
6,39,802,249,128,0.5141,121,0.4859
6,40,665,258,139,0.5388,119,0.4612
6,41,705,295,182,0.6169,113,0.3831
6,42,816,268,153,0.5709,115,0.4291
6,43,717,270,137,0.5074,133,0.4926
6,44,785,323,198,0.613,125,0.387
6,45,713,301,157,0.5216,144,0.4784
6,46,569,219,119,0.5434,100,0.4566
6,47,669,229,132,0.5764,97,0.4236
6,48,745,284,171,0.6021,113,0.3979
7,1,721,229,119,0.5197,110,0.4803
7,2,877,240,128,0.5333,112,0.4667
7,3,628,289,156,0.5398,133,0.4602
7,4,645,289,148,0.5121,141,0.4879
7,5,674,225,111,0.4933,114,0.5067
7,6,798,388,221,0.5696,167,0.4304
7,7,782,225,125,0.5556,100,0.4444
7,8,692,286,200,0.6993,86,0.3007
7,9,1024,506,262,0.5178,244,0.4822
7,10,712,298,176,0.5906,122,0.4094
7,11,788,264,147,0.5568,117,0.4432
7,12,754,260,148,0.5692,112,0.4308
7,13,522,219,150,0.6849,69,0.3151
7,14,778,268,156,0.5821,112,0.4179
7,15,738,302,152,0.5033,150,0.4967
7,16,771,226,122,0.5398,104,0.4602
7,17,711,213,119,0.5587,94,0.4413
7,18,747,228,124,0.5439,104,0.4561
7,19,708,269,169,0.6283,100,0.3717
7,20,681,174,105,0.6034,69,0.3966
7,21,758,196,109,0.5561,87,0.4439
7,22,725,209,112,0.5359,97,0.4641
7,23,655,317,171,0.5394,146,0.4606
7,24,743,263,143,0.5437,120,0.4563
7,25,786,239,112,0.4686,127,0.5314
7,26,568,230,131,0.5696,99,0.4304
7,27,642,231,142,0.6147,89,0.3853
7,28,628,207,113,0.5459,94,0.4541
7,29,665,233,155,0.6652,78,0.3348
7,30,726,208,105,0.5048,103,0.4952
7,31,599,171,80,0.4678,91,0.5322
7,32,764,434,262,0.6037,172,0.3963
7,33,751,407,251,0.6167,156,0.3833
7,34,786,364,208,0.5714,156,0.4286
7,35,755,272,131,0.4816,141,0.5184
7,36,783,353,190,0.5382,163,0.4618
7,37,725,336,193,0.5744,143,0.4256
7,38,658,198,124,0.6263,74,0.3737
7,39,667,279,160,0.5735,119,0.4265
7,40,651,289,167,0.5779,122,0.4221
7,41,736,262,143,0.5458,119,0.4542
7,42,676,275,159,0.5782,116,0.4218
7,43,708,269,158,0.5874,111,0.4126
7,44,729,247,148,0.5992,99,0.4008
7,45,858,262,135,0.5153,127,0.4847
7,46,285,156,108,0.6923,48,0.3077
8,1,723,217,130,0.5991,87,0.4009
8,2,843,281,173,0.6157,108,0.3843
8,3,672,362,213,0.5884,149,0.4116
8,4,648,367,216,0.5886,151,0.4114
8,5,667,373,212,0.5684,161,0.4316
8,6,747,322,197,0.6118,125,0.3882
8,7,766,362,213,0.5884,149,0.4116
8,8,629,335,184,0.5493,151,0.4507
8,9,458,195,115,0.5897,80,0.4103
8,10,695,399,221,0.5539,178,0.4461
8,11,669,275,167,0.6073,108,0.3927
8,12,625,250,138,0.552,112,0.448
8,13,910,320,197,0.6156,123,0.3844
8,14,701,182,104,0.5714,78,0.4286
8,15,702,252,141,0.5595,111,0.4405
8,16,347,91,52,0.5714,39,0.4286
8,17,536,280,178,0.6357,102,0.3643
8,18,917,240,153,0.6375,87,0.3625
8,19,752,361,189,0.5235,172,0.4765
8,20,744,313,175,0.5591,138,0.4409
8,21,886,343,193,0.5627,150,0.4373
8,22,675,269,172,0.6394,97,0.3606
8,23,690,225,115,0.5111,110,0.4889
8,24,368,198,109,0.5505,89,0.4495
8,25,761,295,181,0.6136,114,0.3864
8,26,802,275,168,0.6109,107,0.3891
8,27,668,331,185,0.5589,146,0.4411
8,28,745,304,164,0.5395,140,0.4605
8,29,862,329,182,0.5532,147,0.4468
8,30,771,323,197,0.6099,126,0.3901
8,31,619,225,138,0.6133,87,0.3867
8,32,564,244,143,0.5861,101,0.4139
8,33,703,283,178,0.629,105,0.371
8,34,669,289,190,0.6574,99,0.3426
8,35,719,351,195,0.5556,156,0.4444
8,36,716,319,190,0.5956,129,0.4044
8,37,527,273,155,0.5678,118,0.4322
8,38,548,207,130,0.628,77,0.372
8,39,692,302,187,0.6192,115,0.3808
8,40,515,226,149,0.6593,77,0.3407
8,41,738,307,178,0.5798,129,0.4202
8,42,852,355,194,0.5465,161,0.4535
8,43,468,156,87,0.5577,69,0.4423
8,44,526,184,97,0.5272,87,0.4728
8,45,806,237,136,0.5738,101,0.4262
8,46,598,240,120,0.5,120,0.5
8,47,610,256,163,0.6367,93,0.3633
8,48,786,238,137,0.5756,101,0.4244
8,49,667,296,162,0.5473,134,0.4527
8,50,702,330,207,0.6273,123,0.3727
8,51,674,331,175,0.5287,156,0.4713
8,52,833,406,233,0.5739,173,0.4261
8,53,397,168,105,0.625,63,0.375
8,54,731,227,135,0.5947,92,0.4053
8,55,433,187,120,0.6417,67,0.3583
8,56,693,320,205,0.6406,115,0.3594
9,1,766,286,186,0.6503,100,0.3497
9,2,678,236,143,0.6059,93,0.3941
9,3,836,152,91,0.5987,61,0.4013
9,4,608,226,131,0.5796,95,0.4204
9,5,709,260,159,0.6115,101,0.3885
9,6,697,304,175,0.5757,129,0.4243
9,7,649,190,108,0.5684,82,0.4316
9,8,878,227,129,0.5683,98,0.4317
9,9,763,340,199,0.5853,141,0.4147
9,10,690,240,132,0.55,108,0.45
9,11,644,194,121,0.6237,73,0.3763
9,12,753,311,181,0.582,130,0.418
9,13,711,333,194,0.5826,139,0.4174
9,14,769,366,218,0.5956,148,0.4044
9,15,1043,156,93,0.5962,63,0.4038
9,16,682,242,156,0.6446,86,0.3554
9,17,725,201,121,0.602,80,0.398
9,18,641,194,112,0.5773,82,0.4227
9,19,677,240,133,0.5542,107,0.4458
9,20,727,295,178,0.6034,117,0.3966
9,21,703,257,154,0.5992,103,0.4008
9,22,677,306,178,0.5817,128,0.4183
9,23,701,333,185,0.5556,148,0.4444
9,24,703,285,186,0.6526,99,0.3474
9,25,693,287,154,0.5366,133,0.4634
9,26,941,190,98,0.5158,92,0.4842
9,27,709,253,155,0.6126,98,0.3874
9,28,657,164,71,0.4329,93,0.5671
9,29,737,262,143,0.5458,119,0.4542
9,30,639,222,134,0.6036,88,0.3964
9,31,727,210,127,0.6048,83,0.3952
9,32,708,255,145,0.5686,110,0.4314
9,33,708,188,126,0.6702,62,0.3298
9,34,747,218,131,0.6009,87,0.3991
9,35,669,279,165,0.5914,114,0.4086
9,36,706,226,123,0.5442,103,0.4558
9,37,778,336,193,0.5744,143,0.4256
9,38,711,268,175,0.653,93,0.347
9,39,728,287,168,0.5854,119,0.4146
9,40,774,314,190,0.6051,124,0.3949
9,41,636,226,141,0.6239,85,0.3761
9,42,702,330,166,0.503,164,0.497
9,43,807,216,139,0.6435,77,0.3565
9,44,588,248,102,0.4113,146,0.5887
9,45,676,213,131,0.615,82,0.385
9,46,783,258,152,0.5891,106,0.4109
9,47,691,341,195,0.5718,146,0.4282
9,48,715,315,162,0.5143,153,0.4857
9,49,677,307,183,0.5961,124,0.4039
9,50,760,387,211,0.5452,176,0.4548
9,51,636,302,185,0.6126,117,0.3874
10,1,698,250,127,0.508,123,0.492
10,2,670,379,196,0.5172,183,0.4828
10,3,724,367,223,0.6076,144,0.3924
10,4,842,257,91,0.3541,166,0.6459
10,5,679,305,163,0.5344,142,0.4656
10,6,616,300,124,0.4133,176,0.5867
10,7,630,232,76,0.3276,156,0.6724
10,8,626,165,67,0.4061,98,0.5939
10,9,706,391,206,0.5269,185,0.4731
10,10,698,376,162,0.4309,214,0.5691
10,11,936,478,148,0.3096,330,0.6904
10,12,509,249,93,0.3735,156,0.6265
10,13,898,367,125,0.3406,242,0.6594
10,14,908,497,163,0.328,334,0.672
10,15,1272,552,287,0.5199,265,0.4801
10,16,627,278,160,0.5755,118,0.4245
10,17,881,494,260,0.5263,234,0.4737
10,18,652,193,74,0.3834,119,0.6166
10,19,740,417,169,0.4053,248,0.5947
10,20,742,412,173,0.4199,239,0.5801
10,21,818,388,120,0.3093,268,0.6907
10,22,549,190,40,0.2105,150,0.7895
10,23,697,337,98,0.2908,239,0.7092
10,24,660,408,223,0.5466,185,0.4534
10,25,271,95,38,0.4,57,0.6
10,26,780,266,76,0.2857,190,0.7143
10,27,1042,284,108,0.3803,176,0.6197
10,28,861,423,108,0.2553,315,0.7447
10,29,744,335,99,0.2955,236,0.7045
10,30,762,322,84,0.2609,238,0.7391
10,31,714,258,70,0.2713,188,0.7287
10,32,749,360,146,0.4056,214,0.5944
10,33,593,251,67,0.2669,184,0.7331
10,34,681,211,66,0.3128,145,0.6872
10,35,753,449,211,0.4699,238,0.5301
10,36,203,87,31,0.3563,56,0.6437
11,1,799,385,244,0.6338,141,0.3662
11,2,894,41,17,0.4146,24,0.5854
11,3,647,267,74,0.2772,193,0.7228
11,4,746,355,164,0.462,191,0.538
11,5,1034,430,178,0.414,252,0.586
11,6,854,324,206,0.6358,118,0.3642
11,7,723,244,140,0.5738,104,0.4262
11,8,807,364,192,0.5275,172,0.4725
11,9,827,338,178,0.5266,160,0.4734
11,10,852,368,235,0.6386,133,0.3614
11,11,842,406,222,0.5468,184,0.4532
11,12,992,615,366,0.5951,249,0.4049
11,13,976,555,339,0.6108,216,0.3892
11,14,522,249,182,0.7309,67,0.2691
11,15,364,168,127,0.756,41,0.244
11,16,703,300,181,0.6033,119,0.3967
11,17,772,393,219,0.5573,174,0.4427
11,18,727,355,253,0.7127,102,0.2873
11,19,957,438,223,0.5091,215,0.4909
11,20,581,303,218,0.7195,85,0.2805
11,21,844,583,407,0.6981,176,0.3019
11,22,992,484,273,0.564,211,0.436
11,23,420,271,202,0.7454,69,0.2546
11,24,753,503,378,0.7515,125,0.2485
11,25,671,404,247,0.6114,157,0.3886
11,26,847,508,327,0.6437,181,0.3563
11,27,472,158,96,0.6076,62,0.3924
11,28,465,205,127,0.6195,78,0.3805
11,29,800,499,325,0.6513,174,0.3487
11,30,602,233,180,0.7725,53,0.2275
11,31,718,441,274,0.6213,167,0.3787
11,32,366,237,189,0.7975,48,0.2025
11,33,749,300,200,0.6667,100,0.3333
11,34,309,164,130,0.7927,34,0.2073
11,35,247,154,109,0.7078,45,0.2922
11,36,452,178,119,0.6685,59,0.3315
11,37,332,138,102,0.7391,36,0.2609
11,38,377,150,36,0.24,114,0.76
12,1,670,333,104,0.3123,229,0.6877
12,2,692,255,73,0.2863,182,0.7137
12,3,788,379,114,0.3008,265,0.6992
12,4,698,330,101,0.3061,229,0.6939
12,5,747,289,124,0.4291,165,0.5709
12,6,831,327,104,0.318,223,0.682
12,7,801,261,29,0.1111,232,0.8889
12,8,826,331,128,0.3867,203,0.6133
12,9,664,286,83,0.2902,203,0.7098
12,10,827,302,39,0.1291,263,0.8709
12,11,819,326,56,0.1718,270,0.8282
12,12,819,267,74,0.2772,193,0.7228
12,13,829,316,84,0.2658,232,0.7342
12,14,814,241,25,0.1037,216,0.8963
12,15,850,305,76,0.2492,229,0.7508
12,16,819,294,37,0.1259,257,0.8741
12,17,858,323,91,0.2817,232,0.7183
12,18,850,269,33,0.1227,236,0.8773
12,19,738,304,68,0.2237,236,0.7763
12,20,860,354,79,0.2232,275,0.7768
12,21,781,316,98,0.3101,218,0.6899
12,22,879,242,30,0.124,212,0.876
12,23,725,311,107,0.3441,204,0.6559
13,1,447,267,166,0.6217,101,0.3783
13,2,435,305,207,0.6787,98,0.3213
13,3,433,218,80,0.367,138,0.633
13,4,584,335,215,0.6418,120,0.3582
13,5,626,351,153,0.4359,198,0.5641
13,6,477,325,218,0.6708,107,0.3292
13,7,477,242,125,0.5165,117,0.4835
13,8,407,231,120,0.5195,111,0.4805
13,9,578,288,153,0.5313,135,0.4688
13,10,481,317,212,0.6688,105,0.3312
13,11,567,366,218,0.5956,148,0.4044
13,12,528,285,145,0.5088,140,0.4912
13,13,519,312,139,0.4455,173,0.5545
13,14,519,271,130,0.4797,141,0.5203
13,15,748,438,240,0.5479,198,0.4521
13,16,408,237,108,0.4557,129,0.5443
13,17,482,261,149,0.5709,112,0.4291
13,18,451,243,148,0.6091,95,0.3909
13,19,632,322,121,0.3758,201,0.6242
13,20,371,194,123,0.634,71,0.366
13,21,584,371,247,0.6658,124,0.3342
13,22,575,353,220,0.6232,133,0.3768
13,23,441,233,104,0.4464,129,0.5536
13,24,469,289,157,0.5433,132,0.4567
13,25,573,307,156,0.5081,151,0.4919
13,26,537,310,204,0.6581,106,0.3419
13,27,486,307,187,0.6091,120,0.3909
13,28,453,252,112,0.4444,140,0.5556
13,29,416,248,112,0.4516,136,0.5484
13,30,386,233,104,0.4464,129,0.5536
13,31,588,325,199,0.6123,126,0.3877
13,32,484,277,180,0.6498,97,0.3502
13,33,469,294,189,0.6429,105,0.3571
13,34,527,359,184,0.5125,175,0.4875
13,35,440,281,126,0.4484,155,0.5516
13,36,323,169,74,0.4379,95,0.5621
13,37,581,333,186,0.5586,147,0.4414
13,38,446,283,171,0.6042,112,0.3958
13,39,513,310,147,0.4742,163,0.5258
13,40,431,254,149,0.5866,105,0.4134
13,41,549,284,128,0.4507,156,0.5493
13,42,527,310,192,0.6194,118,0.3806
13,43,503,328,193,0.5884,135,0.4116
13,44,588,409,310,0.7579,99,0.2421
13,45,567,302,208,0.6887,94,0.3113
13,46,639,357,139,0.3894,218,0.6106
13,47,592,313,142,0.4537,171,0.5463
13,48,441,283,197,0.6961,86,0.3039
14,1,673,416,246,0.5913,170,0.4087
14,2,850,421,155,0.3682,266,0.6318
14,3,651,295,75,0.2542,220,0.7458
14,4,586,321,194,0.6044,127,0.3956
14,5,927,372,88,0.2366,284,0.7634
14,6,306,146,42,0.2877,104,0.7123
14,7,782,326,92,0.2822,234,0.7178
14,8,765,303,81,0.2673,222,0.7327
14,9,714,360,202,0.5611,158,0.4389
14,10,494,220,72,0.3273,148,0.6727
14,11,379,171,55,0.3216,116,0.6784
14,12,657,312,128,0.4103,184,0.5897
14,13,501,238,88,0.3697,150,0.6303
14,14,603,273,75,0.2747,198,0.7253
14,15,677,302,76,0.2517,226,0.7483
14,16,535,227,74,0.326,153,0.674
14,17,549,257,77,0.2996,180,0.7004
14,18,270,136,56,0.4118,80,0.5882
14,19,621,274,59,0.2153,215,0.7847
14,20,500,191,53,0.2775,138,0.7225
14,21,612,289,52,0.1799,237,0.8201
14,22,845,331,147,0.4441,184,0.5559
14,23,523,263,138,0.5247,125,0.4753
14,24,694,406,235,0.5788,171,0.4212
14,25,431,188,34,0.1809,154,0.8191
14,26,499,192,33,0.1719,159,0.8281
14,27,629,267,108,0.4045,159,0.5955
14,28,520,234,92,0.3932,142,0.6068
14,29,555,256,73,0.2852,183,0.7148
14,30,380,155,29,0.1871,126,0.8129
14,31,360,175,33,0.1886,142,0.8114
15,1,790,337,57,0.1691,280,0.8309
15,2,657,172,105,0.6105,67,0.3895
15,3,668,184,100,0.5435,84,0.4565
15,4,803,340,68,0.2,272,0.8
15,5,834,275,47,0.1709,228,0.8291
15,6,855,303,73,0.2409,230,0.7591
15,7,747,225,121,0.5378,104,0.4622
15,8,749,333,63,0.1892,270,0.8108
15,9,915,386,68,0.1762,318,0.8238
15,10,892,373,86,0.2306,287,0.7694
15,11,856,340,74,0.2176,266,0.7824
15,12,803,390,89,0.2282,301,0.7718
15,13,819,258,46,0.1783,212,0.8217
15,14,789,229,30,0.131,199,0.869
15,15,747,224,48,0.2143,176,0.7857
15,16,779,310,77,0.2484,233,0.7516
15,17,655,231,138,0.5974,93,0.4026
15,18,732,199,105,0.5276,94,0.4724
15,19,720,264,89,0.3371,175,0.6629
15,20,754,180,90,0.5,90,0.5
15,21,619,187,108,0.5775,79,0.4225
15,22,778,202,107,0.5297,95,0.4703
15,23,778,216,133,0.6157,83,0.3843
15,24,739,189,92,0.4868,97,0.5132
16,1,782,311,65,0.209,246,0.791
16,2,753,219,131,0.5982,88,0.4018
16,3,712,209,134,0.6411,75,0.3589
16,4,750,226,123,0.5442,103,0.4558
16,5,748,185,97,0.5243,88,0.4757
16,6,728,207,111,0.5362,96,0.4638
16,7,716,222,101,0.455,121,0.545
16,8,642,132,80,0.6061,52,0.3939
16,9,795,245,147,0.6,98,0.4
16,10,716,217,129,0.5945,88,0.4055
16,11,731,227,104,0.4581,123,0.5419
16,12,737,178,103,0.5787,75,0.4213
16,13,777,216,78,0.3611,138,0.6389
16,14,693,185,107,0.5784,78,0.4216
16,15,762,252,162,0.6429,90,0.3571
16,16,698,256,143,0.5586,113,0.4414
16,17,796,228,88,0.386,140,0.614
16,18,759,250,111,0.444,139,0.556
16,19,734,190,92,0.4842,98,0.5158
16,20,695,206,130,0.6311,76,0.3689
16,21,756,186,100,0.5376,86,0.4624
16,22,786,198,106,0.5354,92,0.4646
16,23,763,225,60,0.2667,165,0.7333
16,24,454,151,86,0.5695,65,0.4305
16,25,772,249,150,0.6024,99,0.3976
16,26,695,219,123,0.5616,96,0.4384
16,27,705,189,106,0.5608,83,0.4392
16,28,764,277,160,0.5776,117,0.4224
16,29,767,199,109,0.5477,90,0.4523
16,30,744,209,122,0.5837,87,0.4163
16,31,737,246,154,0.626,92,0.374
16,32,769,234,60,0.2564,174,0.7436
16,33,754,235,134,0.5702,101,0.4298
16,34,744,209,129,0.6172,80,0.3828
16,35,812,220,72,0.3273,148,0.6727
16,36,619,188,116,0.617,72,0.383
17,1,671,259,78,0.3012,181,0.6988
17,2,806,237,128,0.5401,109,0.4599
17,3,830,226,129,0.5708,97,0.4292
17,4,842,300,196,0.6533,104,0.3467
17,5,696,229,128,0.559,101,0.441
17,6,777,224,114,0.5089,110,0.4911
17,7,753,181,62,0.3425,119,0.6575
17,8,815,231,123,0.5325,108,0.4675
17,9,796,263,147,0.5589,116,0.4411
17,10,781,278,158,0.5683,120,0.4317
17,11,705,217,130,0.5991,87,0.4009
17,12,864,268,102,0.3806,166,0.6194
17,13,723,207,123,0.5942,84,0.4058
17,14,778,262,124,0.4733,138,0.5267
17,15,836,260,137,0.5269,123,0.4731
17,16,781,226,97,0.4292,129,0.5708
17,17,776,234,134,0.5726,100,0.4274
17,18,732,295,181,0.6136,114,0.3864
17,19,674,142,80,0.5634,62,0.4366
17,20,749,343,196,0.5714,147,0.4286
17,21,753,353,200,0.5666,153,0.4334
17,22,730,276,147,0.5326,129,0.4674
17,23,635,177,98,0.5537,79,0.4463
17,24,795,300,192,0.64,108,0.36
17,25,675,202,117,0.5792,85,0.4208
17,26,835,313,191,0.6102,122,0.3898
17,27,787,236,137,0.5805,99,0.4195
17,28,695,211,117,0.5545,94,0.4455
17,29,774,220,142,0.6455,78,0.3545
17,30,642,228,87,0.3816,141,0.6184
17,31,699,190,105,0.5526,85,0.4474
17,32,732,175,112,0.64,63,0.36
17,33,689,165,93,0.5636,72,0.4364
17,34,719,188,105,0.5585,83,0.4415
17,35,716,195,114,0.5846,81,0.4154
17,36,729,295,163,0.5525,132,0.4475
17,37,683,219,132,0.6027,87,0.3973
17,38,904,288,170,0.5903,118,0.4097
17,39,712,263,146,0.5551,117,0.4449
17,40,730,256,147,0.5742,109,0.4258
17,41,761,311,202,0.6495,109,0.3505
18,1,617,231,108,0.4675,123,0.5325
18,2,659,272,108,0.3971,164,0.6029
18,3,588,321,145,0.4517,176,0.5483
18,4,631,314,156,0.4968,158,0.5032
18,5,599,202,141,0.698,61,0.302
18,6,533,273,162,0.5934,111,0.4066
18,7,684,297,158,0.532,139,0.468
18,8,648,312,166,0.5321,146,0.4679
18,9,578,309,176,0.5696,133,0.4304
18,10,725,394,215,0.5457,179,0.4543
18,11,584,255,128,0.502,127,0.498
18,12,598,273,161,0.5897,112,0.4103
18,13,674,318,156,0.4906,162,0.5094
18,14,666,299,163,0.5452,136,0.4548
18,15,738,320,131,0.4094,189,0.5906
18,16,641,296,166,0.5608,130,0.4392
18,17,668,312,153,0.4904,159,0.5096
18,18,610,279,170,0.6093,109,0.3907
18,19,650,305,178,0.5836,127,0.4164
18,20,612,251,148,0.5896,103,0.4104
18,21,728,381,194,0.5092,187,0.4908
18,22,705,356,202,0.5674,154,0.4326
18,23,648,270,139,0.5148,131,0.4852
18,24,637,288,124,0.4306,164,0.5694
18,25,626,304,122,0.4013,182,0.5987
18,26,676,364,199,0.5467,165,0.4533
18,27,637,226,119,0.5265,107,0.4735
18,28,609,294,154,0.5238,140,0.4762
18,29,668,308,154,0.5,154,0.5
18,30,673,327,155,0.474,172,0.526
18,31,632,300,130,0.4333,170,0.5667
18,32,666,314,189,0.6019,125,0.3981
18,33,596,238,126,0.5294,112,0.4706
18,34,679,405,236,0.5827,169,0.4173
18,35,652,368,204,0.5543,164,0.4457
18,36,673,293,147,0.5017,146,0.4983
18,37,671,358,178,0.4972,180,0.5028
18,38,636,294,158,0.5374,136,0.4626
18,39,633,210,110,0.5238,100,0.4762
18,40,655,351,151,0.4302,200,0.5698
18,41,697,357,204,0.5714,153,0.4286
18,42,675,249,143,0.5743,106,0.4257
18,43,543,241,96,0.3983,145,0.6017
18,44,593,287,144,0.5017,143,0.4983
18,45,697,286,108,0.3776,178,0.6224
18,46,684,341,144,0.4223,197,0.5777
18,47,576,198,100,0.5051,98,0.4949
18,48,609,218,125,0.5734,93,0.4266
18,49,554,195,101,0.5179,94,0.4821
18,50,635,218,126,0.578,92,0.422
19,1,547,320,228,0.7125,92,0.2875
19,2,754,486,306,0.6296,180,0.3704
19,3,498,282,168,0.5957,114,0.4043
19,4,705,407,248,0.6093,159,0.3907
19,5,616,395,247,0.6253,148,0.3747
19,6,642,379,196,0.5172,183,0.4828
19,7,586,340,212,0.6235,128,0.3765
19,8,705,409,222,0.5428,187,0.4572
19,9,442,253,166,0.6561,87,0.3439
19,10,685,409,256,0.6259,153,0.3741
19,11,653,389,246,0.6324,143,0.3676
19,12,539,297,178,0.5993,119,0.4007
19,13,715,402,212,0.5274,190,0.4726
19,14,692,382,244,0.6387,138,0.3613
19,15,842,477,258,0.5409,219,0.4591
19,16,650,382,226,0.5916,156,0.4084
19,17,549,301,173,0.5748,128,0.4252
19,18,537,318,187,0.5881,131,0.4119
19,19,723,460,279,0.6065,181,0.3935
19,20,579,321,184,0.5732,137,0.4268
19,21,684,330,200,0.6061,130,0.3939
19,22,623,387,223,0.5762,164,0.4238
19,23,612,375,235,0.6267,140,0.3733
19,24,453,295,182,0.6169,113,0.3831
19,25,563,339,228,0.6726,111,0.3274
19,26,619,344,247,0.718,97,0.282
19,27,599,339,176,0.5192,163,0.4808
19,28,745,390,206,0.5282,184,0.4718
19,29,686,343,186,0.5423,157,0.4577
19,30,594,319,203,0.6364,116,0.3636
19,31,502,311,186,0.5981,125,0.4019
19,32,582,316,190,0.6013,126,0.3987
19,33,639,356,200,0.5618,156,0.4382
19,34,556,339,228,0.6726,111,0.3274
19,35,493,312,199,0.6378,113,0.3622
19,36,818,406,233,0.5739,173,0.4261
19,37,578,350,175,0.5,175,0.5
19,38,543,302,174,0.5762,128,0.4238
19,39,263,87,48,0.5517,39,0.4483
19,40,616,376,222,0.5904,154,0.4096
19,41,596,334,190,0.5689,144,0.4311
19,42,466,284,153,0.5387,131,0.4613
19,43,872,426,236,0.554,190,0.446
19,44,715,393,241,0.6132,152,0.3868
19,45,572,348,207,0.5948,141,0.4052
19,46,652,377,257,0.6817,120,0.3183
19,47,820,489,258,0.5276,231,0.4724
19,48,863,347,209,0.6023,138,0.3977
19,49,725,435,232,0.5333,203,0.4667
19,50,506,271,150,0.5535,121,0.4465
19,51,654,413,292,0.707,121,0.293
19,52,719,390,201,0.5154,189,0.4846
19,53,570,332,207,0.6235,125,0.3765
19,54,523,279,146,0.5233,133,0.4767
19,55,571,314,191,0.6083,123,0.3917
19,56,596,384,254,0.6615,130,0.3385
19,57,499,303,171,0.5644,132,0.4356
20,1,665,216,114,0.5278,102,0.4722
20,2,482,116,75,0.6466,41,0.3534
20,3,666,219,122,0.5571,97,0.4429
20,4,514,121,60,0.4959,61,0.5041
20,5,821,253,126,0.498,127,0.502
20,6,508,128,78,0.6094,50,0.3906
20,7,880,212,115,0.5425,97,0.4575
20,8,699,280,172,0.6143,108,0.3857
20,9,786,319,174,0.5455,145,0.4545
20,10,666,196,108,0.551,88,0.449
20,11,951,300,163,0.5433,137,0.4567
20,12,648,133,67,0.5038,66,0.4962
20,13,1022,283,157,0.5548,126,0.4452
20,14,419,168,95,0.5655,73,0.4345
20,15,849,224,41,0.183,183,0.817
20,16,696,298,151,0.5067,147,0.4933
20,17,670,157,69,0.4395,88,0.5605
20,18,681,206,126,0.6117,80,0.3883
20,19,810,257,146,0.5681,111,0.4319
20,20,642,173,33,0.1908,140,0.8092
20,21,753,193,112,0.5803,81,0.4197
20,22,752,339,182,0.5369,157,0.4631
20,23,844,285,172,0.6035,113,0.3965
20,24,680,245,124,0.5061,121,0.4939
20,25,722,237,130,0.5485,107,0.4515
20,26,616,279,131,0.4695,148,0.5305
20,27,525,168,91,0.5417,77,0.4583
20,28,565,190,111,0.5842,79,0.4158
20,29,895,325,203,0.6246,122,0.3754
20,30,428,152,99,0.6513,53,0.3487
20,31,847,246,151,0.6138,95,0.3862
20,32,866,258,166,0.6434,92,0.3566
20,33,589,146,101,0.6918,45,0.3082
20,34,705,286,112,0.3916,174,0.6084
20,35,909,143,80,0.5594,63,0.4406
20,36,378,90,60,0.6667,30,0.3333
20,37,305,92,54,0.587,38,0.413
20,38,386,112,64,0.5714,48,0.4286
20,39,163,43,20,0.4651,23,0.5349
21,1,727,327,208,0.6361,119,0.3639
21,2,670,201,118,0.5871,83,0.4129
21,3,732,305,184,0.6033,121,0.3967
21,4,813,283,151,0.5336,132,0.4664
21,5,731,335,188,0.5612,147,0.4388
21,6,683,257,154,0.5992,103,0.4008
21,7,666,328,198,0.6037,130,0.3963
21,8,703,270,151,0.5593,119,0.4407
21,9,703,334,192,0.5749,142,0.4251
21,10,716,281,163,0.5801,118,0.4199
21,11,735,284,190,0.669,94,0.331
21,12,708,270,161,0.5963,109,0.4037
21,13,771,260,145,0.5577,115,0.4423
21,14,793,349,209,0.5989,140,0.4011
21,15,682,261,151,0.5785,110,0.4215
21,16,694,265,164,0.6189,101,0.3811
21,17,749,250,137,0.548,113,0.452
21,18,763,327,201,0.6147,126,0.3853
21,19,756,303,199,0.6568,104,0.3432
21,20,676,279,170,0.6093,109,0.3907
21,21,697,233,149,0.6395,84,0.3605
21,22,689,281,169,0.6014,112,0.3986
21,23,650,269,146,0.5428,123,0.4572
21,24,719,285,172,0.6035,113,0.3965
21,25,639,279,153,0.5484,126,0.4516
21,26,778,257,157,0.6109,100,0.3891
21,27,720,298,150,0.5034,148,0.4966
21,28,891,333,191,0.5736,142,0.4264
21,29,740,293,170,0.5802,123,0.4198
21,30,684,195,115,0.5897,80,0.4103
21,31,459,219,135,0.6164,84,0.3836
21,32,691,271,164,0.6052,107,0.3948
21,33,748,289,169,0.5848,120,0.4152
21,34,795,276,143,0.5181,133,0.4819
21,35,734,309,202,0.6537,107,0.3463
21,36,698,288,170,0.5903,118,0.4097
21,37,611,237,132,0.557,105,0.443
21,38,735,245,151,0.6163,94,0.3837
21,39,629,206,121,0.5874,85,0.4126
21,40,652,245,161,0.6571,84,0.3429
21,41,722,314,175,0.5573,139,0.4427
21,42,779,314,190,0.6051,124,0.3949
21,43,777,285,177,0.6211,108,0.3789
21,44,741,295,165,0.5593,130,0.4407
21,45,747,289,161,0.5571,128,0.4429
21,46,726,325,180,0.5538,145,0.4462
21,47,732,252,146,0.5794,106,0.4206
21,48,690,265,165,0.6226,100,0.3774
21,49,753,330,182,0.5515,148,0.4485
21,50,707,245,142,0.5796,103,0.4204
21,51,725,326,202,0.6196,124,0.3804
21,52,754,300,160,0.5333,140,0.4667
21,53,575,225,123,0.5467,102,0.4533
21,54,623,230,142,0.6174,88,0.3826
22,1,461,175,102,0.5829,73,0.4171
22,2,732,333,147,0.4414,186,0.5586
22,3,1064,436,26,0.0596,410,0.9404
22,4,670,274,16,0.0584,258,0.9416
22,5,793,320,32,0.1,288,0.9
22,6,808,336,34,0.1012,302,0.8988
22,7,548,240,24,0.1,216,0.9
22,8,785,372,175,0.4704,197,0.5296
22,9,729,257,12,0.0467,245,0.9533
22,10,964,436,50,0.1147,386,0.8853
22,11,771,264,27,0.1023,237,0.8977
22,12,664,293,109,0.372,184,0.628
22,13,808,315,41,0.1302,274,0.8698
22,14,756,229,44,0.1921,185,0.8079
22,15,678,234,21,0.0897,213,0.9103
22,16,659,286,32,0.1119,254,0.8881
22,17,877,333,30,0.0901,303,0.9099
22,18,760,249,25,0.1004,224,0.8996
22,19,413,124,43,0.3468,81,0.6532
22,20,776,305,38,0.1246,267,0.8754
22,21,909,300,123,0.41,177,0.59
22,22,818,268,30,0.1119,238,0.8881
22,23,922,343,216,0.6297,127,0.3703
22,24,978,370,29,0.0784,341,0.9216
22,25,792,337,32,0.095,305,0.905
23,1,544,331,202,0.6103,129,0.3897
23,2,575,309,172,0.5566,137,0.4434
23,3,570,306,197,0.6438,109,0.3562
23,4,612,368,215,0.5842,153,0.4158
23,5,586,285,84,0.2947,201,0.7053
23,6,630,321,118,0.3676,203,0.6324
23,7,568,263,76,0.289,187,0.711
23,8,681,362,182,0.5028,180,0.4972
23,9,525,240,64,0.2667,176,0.7333
23,10,671,337,120,0.3561,217,0.6439
23,11,668,325,79,0.2431,246,0.7569
23,12,552,336,183,0.5446,153,0.4554
23,13,560,193,39,0.2021,154,0.7979
23,14,536,297,173,0.5825,124,0.4175
23,15,586,258,74,0.2868,184,0.7132
23,16,546,313,187,0.5974,126,0.4026
23,17,548,177,37,0.209,140,0.791
23,18,557,279,132,0.4731,147,0.5269
23,19,606,235,50,0.2128,185,0.7872
23,20,559,184,45,0.2446,139,0.7554
23,21,570,319,191,0.5987,128,0.4013
23,22,612,303,170,0.5611,133,0.4389
23,23,546,325,180,0.5538,145,0.4462
23,24,584,236,54,0.2288,182,0.7712
23,25,654,278,96,0.3453,182,0.6547
23,26,641,306,130,0.4248,176,0.5752
23,27,514,329,186,0.5653,143,0.4347
23,28,587,327,167,0.5107,160,0.4893
23,29,529,267,149,0.5581,118,0.4419
23,30,648,332,99,0.2982,233,0.7018
23,31,549,240,50,0.2083,190,0.7917
23,32,617,302,93,0.3079,209,0.6921
23,33,682,292,60,0.2055,232,0.7945
23,34,651,257,68,0.2646,189,0.7354
23,35,458,255,130,0.5098,125,0.4902
23,36,555,353,226,0.6402,127,0.3598
23,37,552,313,201,0.6422,112,0.3578
23,38,515,276,155,0.5616,121,0.4384
23,39,623,283,71,0.2509,212,0.7491
24,1,746,216,113,0.5231,103,0.4769
24,2,803,196,101,0.5153,95,0.4847
24,3,848,223,125,0.5605,98,0.4395
24,4,566,187,114,0.6096,73,0.3904
24,5,458,136,66,0.4853,70,0.5147
24,6,715,232,120,0.5172,112,0.4828
24,7,415,149,41,0.2752,108,0.7248
24,8,469,150,79,0.5267,71,0.4733
24,9,774,220,124,0.5636,96,0.4364
24,10,425,132,58,0.4394,74,0.5606
24,11,892,227,121,0.533,106,0.467
24,12,487,125,73,0.584,52,0.416
24,13,466,116,72,0.6207,44,0.3793
24,14,766,193,105,0.544,88,0.456
24,15,491,139,76,0.5468,63,0.4532
24,16,770,263,60,0.2281,203,0.7719
24,17,634,158,86,0.5443,72,0.4557
24,18,784,252,133,0.5278,119,0.4722
24,19,841,247,140,0.5668,107,0.4332
24,20,636,172,93,0.5407,79,0.4593
24,21,426,113,61,0.5398,52,0.4602
24,22,916,279,159,0.5699,120,0.4301
24,23,739,201,100,0.4975,101,0.5025
24,24,1047,274,133,0.4854,141,0.5146
24,25,737,188,110,0.5851,78,0.4149
24,26,852,320,194,0.6063,126,0.3938
24,27,776,231,126,0.5455,105,0.4545
24,28,582,184,91,0.4946,93,0.5054
24,29,487,168,99,0.5893,69,0.4107
24,30,409,123,65,0.5285,58,0.4715
24,31,807,249,127,0.51,122,0.49
24,32,440,134,81,0.6045,53,0.3955
24,33,480,125,72,0.576,53,0.424
24,34,742,200,110,0.55,90,0.45
24,35,638,309,162,0.5243,147,0.4757
24,36,920,287,154,0.5366,133,0.4634
24,37,476,136,73,0.5368,63,0.4632
24,38,572,214,80,0.3738,134,0.6262
24,39,781,296,147,0.4966,149,0.5034
24,40,827,207,110,0.5314,97,0.4686
24,41,539,155,99,0.6387,56,0.3613
25,1,662,312,84,0.2692,228,0.7308
25,2,782,319,66,0.2069,253,0.7931
25,3,841,250,172,0.688,78,0.312
25,4,718,230,142,0.6174,88,0.3826
25,5,805,353,101,0.2861,252,0.7139
25,6,692,143,103,0.7203,40,0.2797
25,7,835,344,52,0.1512,292,0.8488
25,8,808,351,55,0.1567,296,0.8433
25,9,839,343,51,0.1487,292,0.8513
25,10,852,318,276,0.8679,42,0.1321
25,11,853,352,67,0.1903,285,0.8097
25,12,755,326,70,0.2147,256,0.7853
25,13,860,379,55,0.1451,324,0.8549
25,14,744,249,181,0.7269,68,0.2731
25,15,739,323,88,0.2724,235,0.7276
25,16,855,301,256,0.8505,45,0.1495
25,17,775,378,95,0.2513,283,0.7487
25,18,911,333,266,0.7988,67,0.2012
25,19,936,389,65,0.1671,324,0.8329
25,20,768,213,138,0.6479,75,0.3521
25,21,941,316,233,0.7373,83,0.2627
25,22,780,326,59,0.181,267,0.819
25,23,795,360,74,0.2056,286,0.7944
25,24,842,359,55,0.1532,304,0.8468
25,25,694,309,209,0.6764,100,0.3236
25,26,800,318,59,0.1855,259,0.8145
25,27,835,220,150,0.6818,70,0.3182
25,28,818,368,62,0.1685,306,0.8315
25,29,760,272,163,0.5993,109,0.4007
25,30,806,309,51,0.165,258,0.835
25,31,875,312,258,0.8269,54,0.1731
25,32,755,299,83,0.2776,216,0.7224
26,1,615,197,82,0.4162,115,0.5838
26,2,602,211,55,0.2607,156,0.7393
26,3,584,212,95,0.4481,117,0.5519
26,4,564,168,60,0.3571,108,0.6429
26,5,526,193,58,0.3005,135,0.6995
26,6,652,230,72,0.313,158,0.687
26,7,455,161,49,0.3043,112,0.6957
26,8,408,115,26,0.2261,89,0.7739
26,9,601,197,60,0.3046,137,0.6954
26,10,539,196,59,0.301,137,0.699
26,11,554,205,59,0.2878,146,0.7122
26,12,622,190,74,0.3895,116,0.6105
26,13,433,140,52,0.3714,88,0.6286
26,14,442,154,34,0.2208,120,0.7792
26,15,483,125,43,0.344,82,0.656
26,16,451,125,39,0.312,86,0.688
26,17,450,205,116,0.5659,89,0.4341
26,18,517,201,80,0.398,121,0.602
26,19,458,131,43,0.3282,88,0.6718
26,20,583,191,84,0.4398,107,0.5602
26,21,785,220,73,0.3318,147,0.6682
26,22,454,146,41,0.2808,105,0.7192
26,23,478,142,44,0.3099,98,0.6901
26,24,568,199,67,0.3367,132,0.6633
26,25,519,191,55,0.288,136,0.712
26,26,482,131,43,0.3282,88,0.6718
26,27,634,240,89,0.3708,151,0.6292
26,28,618,235,127,0.5404,108,0.4596
26,29,401,146,53,0.363,93,0.637
26,30,399,158,48,0.3038,110,0.6962
26,31,358,118,34,0.2881,84,0.7119
26,32,621,217,115,0.53,102,0.47
26,33,569,201,72,0.3582,129,0.6418
26,34,596,228,81,0.3553,147,0.6447
26,35,566,220,84,0.3818,136,0.6182
26,36,515,164,57,0.3476,107,0.6524
26,37,606,207,54,0.2609,153,0.7391
26,38,376,126,39,0.3095,87,0.6905
26,39,601,213,79,0.3709,134,0.6291
26,40,384,98,32,0.3265,66,0.6735
26,41,624,218,81,0.3716,137,0.6284
26,42,435,170,48,0.2824,122,0.7176
26,43,470,145,38,0.2621,107,0.7379
26,44,365,127,41,0.3228,86,0.6772
26,45,418,99,30,0.303,69,0.697
26,46,369,135,66,0.4889,69,0.5111
26,47,517,173,41,0.237,132,0.763
26,48,491,172,59,0.343,113,0.657
26,49,423,124,31,0.25,93,0.75
27,1,758,249,203,0.8153,46,0.1847
27,2,785,295,207,0.7017,88,0.2983
27,3,576,146,75,0.5137,71,0.4863
27,4,461,145,75,0.5172,70,0.4828
27,5,680,178,102,0.573,76,0.427
27,6,589,195,132,0.6769,63,0.3231
27,7,831,296,149,0.5034,147,0.4966
27,8,724,185,110,0.5946,75,0.4054
27,9,310,108,87,0.8056,21,0.1944
27,10,787,266,176,0.6617,90,0.3383
27,11,635,230,173,0.7522,57,0.2478
27,12,443,177,144,0.8136,33,0.1864
27,13,904,371,221,0.5957,150,0.4043
27,14,508,119,73,0.6134,46,0.3866
27,15,689,169,117,0.6923,52,0.3077
27,16,622,181,137,0.7569,44,0.2431
27,17,755,226,135,0.5973,91,0.4027
27,18,687,193,126,0.6528,67,0.3472
27,19,696,160,89,0.5563,71,0.4438
27,20,636,175,108,0.6171,67,0.3829
27,21,571,245,205,0.8367,40,0.1633
27,22,626,152,74,0.4868,78,0.5132
27,23,620,210,126,0.6,84,0.4
27,24,765,199,79,0.397,120,0.603
27,25,670,194,117,0.6031,77,0.3969
27,26,606,215,111,0.5163,104,0.4837
27,27,813,230,150,0.6522,80,0.3478
27,28,277,125,72,0.576,53,0.424
27,29,747,180,74,0.4111,106,0.5889
27,30,461,125,71,0.568,54,0.432
27,31,628,186,106,0.5699,80,0.4301
27,32,644,192,102,0.5313,90,0.4688
27,33,685,233,162,0.6953,71,0.3047
27,34,708,233,162,0.6953,71,0.3047
27,35,692,239,172,0.7197,67,0.2803
27,36,540,177,98,0.5537,79,0.4463
27,37,666,295,216,0.7322,79,0.2678
27,38,930,417,310,0.7434,107,0.2566
27,39,512,199,115,0.5779,84,0.4221
27,40,857,297,178,0.5993,119,0.4007
27,41,720,251,171,0.6813,80,0.3187
27,42,421,177,121,0.6836,56,0.3164
27,43,664,177,93,0.5254,84,0.4746
27,44,741,186,104,0.5591,82,0.4409
27,45,744,264,182,0.6894,82,0.3106
27,46,444,187,168,0.8984,19,0.1016
27,47,524,217,139,0.6406,78,0.3594
27,48,935,272,175,0.6434,97,0.3566
27,49,629,149,85,0.5705,64,0.4295
27,50,689,206,128,0.6214,78,0.3786
28,1,686,180,99,0.55,81,0.45
28,2,688,179,94,0.5251,85,0.4749
28,3,610,151,72,0.4768,79,0.5232
28,4,544,183,114,0.623,69,0.377
28,5,346,167,101,0.6048,66,0.3952
28,6,258,153,102,0.6667,51,0.3333
28,7,889,220,122,0.5545,98,0.4455
28,8,500,131,94,0.7176,37,0.2824
28,9,921,199,126,0.6332,73,0.3668
28,10,701,235,150,0.6383,85,0.3617
28,11,1204,361,157,0.4349,204,0.5651
28,12,799,222,143,0.6441,79,0.3559
28,13,668,199,109,0.5477,90,0.4523
28,14,753,218,141,0.6468,77,0.3532
28,15,249,81,58,0.716,23,0.284
28,16,573,140,87,0.6214,53,0.3786
28,17,698,171,108,0.6316,63,0.3684
28,18,462,182,117,0.6429,65,0.3571
28,19,566,212,82,0.3868,130,0.6132
28,20,667,223,108,0.4843,115,0.5157
28,21,592,185,116,0.627,69,0.373
28,22,613,180,85,0.4722,95,0.5278
28,23,976,245,141,0.5755,104,0.4245
28,24,762,192,110,0.5729,82,0.4271
28,25,860,273,134,0.4908,139,0.5092
28,26,928,222,135,0.6081,87,0.3919
28,27,555,243,151,0.6214,92,0.3786
28,28,613,268,177,0.6604,91,0.3396
28,29,632,93,55,0.5914,38,0.4086
28,30,91,47,27,0.5745,20,0.4255
28,31,996,318,208,0.6541,110,0.3459
28,32,778,195,117,0.6,78,0.4
28,33,904,243,146,0.6008,97,0.3992
28,34,1311,286,157,0.549,129,0.451
28,35,941,233,117,0.5021,116,0.4979
28,36,493,142,81,0.5704,61,0.4296
28,37,1070,293,186,0.6348,107,0.3652
28,38,464,115,64,0.5565,51,0.4435
28,39,590,167,102,0.6108,65,0.3892
28,40,964,262,164,0.626,98,0.374
28,41,647,165,85,0.5152,80,0.4848
28,42,838,242,131,0.5413,111,0.4587
28,43,985,255,170,0.6667,85,0.3333
28,44,639,159,84,0.5283,75,0.4717
28,45,727,177,118,0.6667,59,0.3333
28,46,1078,404,171,0.4233,233,0.5767
29,1,754,397,217,0.5466,180,0.4534
29,2,1182,406,257,0.633,149,0.367
29,3,985,301,200,0.6645,101,0.3355
29,4,928,320,195,0.6094,125,0.3906
29,5,781,253,143,0.5652,110,0.4348
29,6,839,234,138,0.5897,96,0.4103
29,7,644,300,189,0.63,111,0.37
29,8,830,171,98,0.5731,73,0.4269
29,9,728,375,191,0.5093,184,0.4907
29,10,765,448,263,0.5871,185,0.4129
29,11,508,175,89,0.5086,86,0.4914
29,12,843,359,216,0.6017,143,0.3983
29,13,882,298,169,0.5671,129,0.4329
29,14,761,303,155,0.5116,148,0.4884
29,15,823,361,217,0.6011,144,0.3989
29,16,851,299,177,0.592,122,0.408
29,17,712,272,176,0.6471,96,0.3529
29,18,807,263,162,0.616,101,0.384
29,19,813,314,165,0.5255,149,0.4745
29,20,1035,385,216,0.561,169,0.439
29,21,1098,288,181,0.6285,107,0.3715
29,22,742,218,99,0.4541,119,0.5459
29,23,736,331,161,0.4864,170,0.5136
29,24,702,259,165,0.6371,94,0.3629
29,25,837,342,228,0.6667,114,0.3333
29,26,726,302,172,0.5695,130,0.4305
29,27,684,255,146,0.5725,109,0.4275
29,28,1027,356,194,0.5449,162,0.4551
29,29,793,297,165,0.5556,132,0.4444
29,30,738,393,227,0.5776,166,0.4224
29,31,778,286,164,0.5734,122,0.4266
29,32,754,267,131,0.4906,136,0.5094
29,33,504,250,141,0.564,109,0.436
29,34,445,200,112,0.56,88,0.44
29,35,672,183,101,0.5519,82,0.4481
29,36,670,274,186,0.6788,88,0.3212
29,37,750,281,156,0.5552,125,0.4448
29,38,752,258,123,0.4767,135,0.5233
29,39,787,282,142,0.5035,140,0.4965
29,40,834,331,201,0.6073,130,0.3927
29,41,707,249,153,0.6145,96,0.3855
29,42,912,283,171,0.6042,112,0.3958
29,43,751,390,195,0.5,195,0.5
29,44,1011,367,199,0.5422,168,0.4578
30,1,761,283,119,0.4205,164,0.5795
30,2,790,276,127,0.4601,149,0.5399
30,3,482,211,93,0.4408,118,0.5592
30,4,747,282,134,0.4752,148,0.5248
30,5,683,200,71,0.355,129,0.645
30,6,610,228,99,0.4342,129,0.5658
30,7,764,297,101,0.3401,196,0.6599
30,8,829,312,147,0.4712,165,0.5288
30,9,691,224,113,0.5045,111,0.4955
30,10,881,279,112,0.4014,167,0.5986
30,11,705,219,66,0.3014,153,0.6986
30,12,735,234,95,0.406,139,0.594
30,13,699,252,112,0.4444,140,0.5556
30,14,582,172,63,0.3663,109,0.6337
30,15,541,289,178,0.6159,111,0.3841
30,16,427,140,56,0.4,84,0.6
30,17,749,271,141,0.5203,130,0.4797
30,18,815,254,73,0.2874,181,0.7126
30,19,800,251,60,0.239,191,0.761
30,20,721,285,105,0.3684,180,0.6316
30,21,583,240,106,0.4417,134,0.5583
30,22,873,287,88,0.3066,199,0.6934
30,23,800,238,82,0.3445,156,0.6555
30,24,838,240,81,0.3375,159,0.6625
30,25,927,271,106,0.3911,165,0.6089
30,26,523,175,77,0.44,98,0.56
30,27,476,157,74,0.4713,83,0.5287
30,28,690,280,132,0.4714,148,0.5286
30,29,530,148,53,0.3581,95,0.6419
30,30,380,114,37,0.3246,77,0.6754
30,31,470,191,86,0.4503,105,0.5497
30,32,503,190,80,0.4211,110,0.5789
31,1,607,208,57,0.274,151,0.726
31,2,483,175,59,0.3371,116,0.6629
31,3,529,237,99,0.4177,138,0.5823
31,4,573,236,78,0.3305,158,0.6695
31,5,500,224,82,0.3661,142,0.6339
31,6,442,214,87,0.4065,127,0.5935
31,7,585,223,78,0.3498,145,0.6502
31,8,466,151,60,0.3974,91,0.6026
31,9,609,248,95,0.3831,153,0.6169
31,10,528,181,77,0.4254,104,0.5746
31,11,468,186,86,0.4624,100,0.5376
31,12,506,183,80,0.4372,103,0.5628
31,13,621,231,59,0.2554,172,0.7446
31,14,495,203,90,0.4433,113,0.5567
31,15,486,178,68,0.382,110,0.618
31,16,613,246,60,0.2439,186,0.7561
31,17,547,221,102,0.4615,119,0.5385
31,18,531,203,84,0.4138,119,0.5862
31,19,454,188,85,0.4521,103,0.5479
31,20,489,203,73,0.3596,130,0.6404
31,21,518,187,77,0.4118,110,0.5882
31,22,498,176,43,0.2443,133,0.7557
31,23,511,194,80,0.4124,114,0.5876
31,24,557,228,93,0.4079,135,0.5921
31,25,545,187,64,0.3422,123,0.6578
31,26,539,230,97,0.4217,133,0.5783
31,27,625,250,104,0.416,146,0.584
31,28,511,178,62,0.3483,116,0.6517
31,29,588,248,122,0.4919,126,0.5081
31,30,454,168,64,0.381,104,0.619
31,31,478,209,78,0.3732,131,0.6268
31,32,490,174,55,0.3161,119,0.6839
31,33,493,200,95,0.475,105,0.525
31,34,541,204,91,0.4461,113,0.5539
31,35,585,245,84,0.3429,161,0.6571
31,36,517,245,101,0.4122,144,0.5878
31,37,507,188,76,0.4043,112,0.5957
31,38,559,210,79,0.3762,131,0.6238
31,39,569,193,48,0.2487,145,0.7513
31,40,583,209,71,0.3397,138,0.6603
31,41,592,195,49,0.2513,146,0.7487
32,1,897,282,172,0.6099,110,0.3901
32,2,700,249,188,0.755,61,0.245
32,3,778,358,139,0.3883,219,0.6117
32,4,696,299,208,0.6957,91,0.3043
32,5,699,287,172,0.5993,115,0.4007
32,6,712,258,203,0.7868,55,0.2132
32,7,762,315,234,0.7429,81,0.2571
32,8,843,322,270,0.8385,52,0.1615
32,9,753,301,188,0.6246,113,0.3754
32,10,804,287,206,0.7178,81,0.2822
32,11,617,301,117,0.3887,184,0.6113
32,12,616,267,81,0.3034,186,0.6966
32,13,763,282,223,0.7908,59,0.2092
32,14,668,274,107,0.3905,167,0.6095
32,15,716,264,164,0.6212,100,0.3788
32,16,670,289,156,0.5398,133,0.4602
32,17,725,316,131,0.4146,185,0.5854
32,18,668,300,250,0.8333,50,0.1667
32,19,715,253,138,0.5455,115,0.4545
32,20,725,324,78,0.2407,246,0.7593
32,21,712,331,216,0.6526,115,0.3474
32,22,849,360,146,0.4056,214,0.5944
32,23,705,256,201,0.7852,55,0.2148
32,24,633,196,167,0.852,29,0.148
32,25,736,261,162,0.6207,99,0.3793
32,26,760,340,158,0.4647,182,0.5353
32,27,649,321,253,0.7882,68,0.2118
32,28,767,301,123,0.4086,178,0.5914
32,29,693,316,170,0.538,146,0.462
32,30,712,290,248,0.8552,42,0.1448
32,31,703,295,213,0.722,82,0.278
32,32,741,299,211,0.7057,88,0.2943
32,33,743,319,216,0.6771,103,0.3229
32,34,715,262,154,0.5878,108,0.4122
32,35,697,258,183,0.7093,75,0.2907
32,36,711,287,209,0.7282,78,0.2718
32,37,721,222,122,0.5495,100,0.4505
32,38,700,254,165,0.6496,89,0.3504
32,39,759,348,295,0.8477,53,0.1523
32,40,740,338,263,0.7781,75,0.2219
32,41,743,297,222,0.7475,75,0.2525
32,42,723,264,169,0.6402,95,0.3598
32,43,645,286,117,0.4091,169,0.5909
33,1,836,325,122,0.3754,203,0.6246
33,2,963,416,172,0.4135,244,0.5865
33,3,884,374,142,0.3797,232,0.6203
33,4,943,370,149,0.4027,221,0.5973
33,5,754,285,139,0.4877,146,0.5123
33,6,769,300,130,0.4333,170,0.5667
33,7,875,349,173,0.4957,176,0.5043
33,8,903,478,256,0.5356,222,0.4644
33,9,819,351,185,0.5271,166,0.4729
33,10,765,365,218,0.5973,147,0.4027
33,11,799,348,145,0.4167,203,0.5833
33,12,852,344,159,0.4622,185,0.5378
33,13,713,310,98,0.3161,212,0.6839
33,14,480,159,45,0.283,114,0.717
33,15,864,407,149,0.3661,258,0.6339
33,16,1091,487,233,0.4784,254,0.5216
33,17,858,395,161,0.4076,234,0.5924
33,18,1025,396,151,0.3813,245,0.6187
33,19,874,301,130,0.4319,171,0.5681
33,20,855,377,153,0.4058,224,0.5942
33,21,843,351,151,0.4302,200,0.5698
33,22,775,387,211,0.5452,176,0.4548
33,23,775,355,175,0.493,180,0.507
33,24,913,545,326,0.5982,219,0.4018
33,25,983,407,158,0.3882,249,0.6118
33,26,622,230,78,0.3391,152,0.6609
33,27,802,264,115,0.4356,149,0.5644
33,28,689,261,88,0.3372,173,0.6628
34,1,735,318,189,0.5943,129,0.4057
34,2,678,270,175,0.6481,95,0.3519
34,3,805,297,182,0.6128,115,0.3872
34,4,701,222,132,0.5946,90,0.4054
34,5,707,253,162,0.6403,91,0.3597
34,6,771,350,227,0.6486,123,0.3514
34,7,730,322,206,0.6398,116,0.3602
34,8,700,219,122,0.5571,97,0.4429
34,9,800,226,126,0.5575,100,0.4425
34,10,715,301,171,0.5681,130,0.4319
34,11,810,223,138,0.6188,85,0.3812
34,12,772,312,194,0.6218,118,0.3782
34,13,747,298,172,0.5772,126,0.4228
34,14,724,220,125,0.5682,95,0.4318
34,15,791,202,124,0.6139,78,0.3861
34,16,784,228,140,0.614,88,0.386
34,17,876,350,221,0.6314,129,0.3686
34,18,797,204,121,0.5931,83,0.4069
34,19,864,274,169,0.6168,105,0.3832
34,20,772,360,251,0.6972,109,0.3028
34,21,778,375,251,0.6693,124,0.3307
34,22,678,290,194,0.669,96,0.331
34,23,663,236,146,0.6186,90,0.3814
34,24,731,235,145,0.617,90,0.383
34,25,764,339,232,0.6844,107,0.3156
34,26,824,290,169,0.5828,121,0.4172
34,27,735,231,136,0.5887,95,0.4113
34,28,673,187,119,0.6364,68,0.3636
34,29,663,220,121,0.55,99,0.45
34,30,602,304,176,0.5789,128,0.4211
34,31,801,219,149,0.6804,70,0.3196
34,32,761,264,177,0.6705,87,0.3295
34,33,748,223,127,0.5695,96,0.4305
34,34,730,301,173,0.5748,128,0.4252
34,35,823,292,169,0.5788,123,0.4212
34,36,648,275,153,0.5564,122,0.4436
34,37,691,165,99,0.6,66,0.4
34,38,715,167,111,0.6647,56,0.3353
34,39,766,221,122,0.552,99,0.448
34,40,805,305,183,0.6,122,0.4
34,41,633,200,118,0.59,82,0.41
34,42,655,315,191,0.6063,124,0.3937
34,43,601,286,170,0.5944,116,0.4056
34,44,700,280,177,0.6321,103,0.3679
34,45,768,311,200,0.6431,111,0.3569
34,46,462,190,116,0.6105,74,0.3895
34,47,785,235,173,0.7362,62,0.2638
34,48,718,325,199,0.6123,126,0.3877
34,49,916,355,201,0.5662,154,0.4338
34,50,737,224,124,0.5536,100,0.4464
34,51,691,317,184,0.5804,133,0.4196
34,52,495,231,147,0.6364,84,0.3636
34,53,675,180,117,0.65,63,0.35
35,1,732,293,99,0.3379,194,0.6621
35,2,684,349,131,0.3754,218,0.6246
35,3,707,237,75,0.3165,162,0.6835
35,4,687,311,132,0.4244,179,0.5756
35,5,664,256,74,0.2891,182,0.7109
35,6,724,254,81,0.3189,173,0.6811
35,7,636,257,56,0.2179,201,0.7821
35,8,677,242,59,0.2438,183,0.7562
35,9,742,302,122,0.404,180,0.596
35,10,774,334,107,0.3204,227,0.6796
35,11,804,307,91,0.2964,216,0.7036
35,12,690,194,44,0.2268,150,0.7732
35,13,703,191,45,0.2356,146,0.7644
35,14,710,225,62,0.2756,163,0.7244
35,15,835,322,76,0.236,246,0.764
35,16,687,197,47,0.2386,150,0.7614
35,17,694,270,118,0.437,152,0.563
35,18,687,239,77,0.3222,162,0.6778
35,19,675,179,51,0.2849,128,0.7151
35,20,691,220,78,0.3545,142,0.6455
35,21,751,244,78,0.3197,166,0.6803
35,22,800,292,123,0.4212,169,0.5788
35,23,715,272,118,0.4338,154,0.5662
35,24,665,251,81,0.3227,170,0.6773
35,25,690,284,112,0.3944,172,0.6056
35,26,696,235,94,0.4,141,0.6
35,27,680,230,97,0.4217,133,0.5783
35,28,742,272,98,0.3603,174,0.6397
35,29,797,218,80,0.367,138,0.633
35,30,787,273,124,0.4542,149,0.5458
35,31,717,321,139,0.433,182,0.567
36,1,724,278,126,0.4532,152,0.5468
36,2,708,293,92,0.314,201,0.686
36,3,608,289,102,0.3529,187,0.6471
36,4,786,289,109,0.3772,180,0.6228
36,5,772,293,108,0.3686,185,0.6314
36,6,712,239,88,0.3682,151,0.6318
36,7,737,384,227,0.5911,157,0.4089
36,8,638,247,51,0.2065,196,0.7935
36,9,754,249,66,0.2651,183,0.7349
36,10,804,297,98,0.33,199,0.67
36,11,628,214,82,0.3832,132,0.6168
36,12,681,167,46,0.2754,121,0.7246
36,13,600,194,49,0.2526,145,0.7474
36,14,738,300,145,0.4833,155,0.5167
36,15,740,337,180,0.5341,157,0.4659
36,16,719,318,154,0.4843,164,0.5157
36,17,753,343,181,0.5277,162,0.4723
36,18,706,309,175,0.5663,134,0.4337
36,19,809,318,135,0.4245,183,0.5755
36,20,724,284,139,0.4894,145,0.5106
36,21,734,230,75,0.3261,155,0.6739
36,22,699,217,46,0.212,171,0.788
36,23,692,243,73,0.3004,170,0.6996
36,24,762,338,170,0.503,168,0.497
36,25,744,242,64,0.2645,178,0.7355
36,26,692,270,170,0.6296,100,0.3704
36,27,644,272,117,0.4301,155,0.5699
36,28,716,265,127,0.4792,138,0.5208
36,29,821,361,181,0.5014,180,0.4986
36,30,748,318,175,0.5503,143,0.4497
37,1,713,229,154,0.6725,75,0.3275
37,2,643,176,73,0.4148,103,0.5852
37,3,722,168,103,0.6131,65,0.3869
37,4,694,220,131,0.5955,89,0.4045
37,5,814,296,188,0.6351,108,0.3649
37,6,806,265,154,0.5811,111,0.4189
37,7,678,192,102,0.5313,90,0.4688
37,8,701,193,98,0.5078,95,0.4922
37,9,860,248,150,0.6048,98,0.3952
37,10,816,315,171,0.5429,144,0.4571
37,11,754,173,115,0.6647,58,0.3353
37,12,707,191,91,0.4764,100,0.5236
37,13,666,192,115,0.599,77,0.401
37,14,821,265,172,0.6491,93,0.3509
37,15,829,287,191,0.6655,96,0.3345
37,16,807,268,152,0.5672,116,0.4328
37,17,749,216,150,0.6944,66,0.3056
37,18,769,264,150,0.5682,114,0.4318
37,19,804,189,85,0.4497,104,0.5503
37,20,775,209,119,0.5694,90,0.4306
37,21,738,240,133,0.5542,107,0.4458
37,22,821,240,111,0.4625,129,0.5375
37,23,751,271,167,0.6162,104,0.3838
37,24,804,279,178,0.638,101,0.362
37,25,775,257,159,0.6187,98,0.3813
37,26,787,337,203,0.6024,134,0.3976
37,27,803,270,146,0.5407,124,0.4593
37,28,634,206,109,0.5291,97,0.4709
37,29,802,279,151,0.5412,128,0.4588
37,30,834,241,128,0.5311,113,0.4689
37,31,814,292,172,0.589,120,0.411
37,32,750,250,138,0.552,112,0.448
37,33,817,273,165,0.6044,108,0.3956
37,34,797,259,165,0.6371,94,0.3629
37,35,792,279,187,0.6703,92,0.3297
37,36,833,213,142,0.6667,71,0.3333
37,37,863,267,169,0.633,98,0.367
37,38,798,304,164,0.5395,140,0.4605
37,39,789,229,124,0.5415,105,0.4585
37,40,789,295,185,0.6271,110,0.3729
37,41,689,323,183,0.5666,140,0.4334
38,1,656,274,155,0.5657,119,0.4343
38,2,714,390,253,0.6487,137,0.3513
38,3,773,310,191,0.6161,119,0.3839
38,4,688,327,203,0.6208,124,0.3792
38,5,740,320,181,0.5656,139,0.4344
38,6,781,304,163,0.5362,141,0.4638
38,7,752,327,213,0.6514,114,0.3486
38,8,721,287,171,0.5958,116,0.4042
38,9,795,348,202,0.5805,146,0.4195
38,10,655,255,134,0.5255,121,0.4745
38,11,630,288,169,0.5868,119,0.4132
38,12,740,326,221,0.6779,105,0.3221
38,13,801,339,187,0.5516,152,0.4484
38,14,781,320,185,0.5781,135,0.4219
38,15,670,273,163,0.5971,110,0.4029
38,16,733,334,201,0.6018,133,0.3982
38,17,809,338,194,0.574,144,0.426
38,18,763,329,220,0.6687,109,0.3313
38,19,807,375,285,0.76,90,0.24
38,20,777,297,186,0.6263,111,0.3737
38,21,697,238,136,0.5714,102,0.4286
38,22,667,294,174,0.5918,120,0.4082
38,23,738,336,203,0.6042,133,0.3958
38,24,763,375,239,0.6373,136,0.3627
38,25,632,244,149,0.6107,95,0.3893
38,26,749,342,229,0.6696,113,0.3304
38,27,768,318,200,0.6289,118,0.3711
38,28,830,377,239,0.634,138,0.366
38,29,739,295,170,0.5763,125,0.4237
38,30,786,297,174,0.5859,123,0.4141
38,31,661,302,162,0.5364,140,0.4636
38,32,721,277,166,0.5993,111,0.4007
38,33,716,285,147,0.5158,138,0.4842
38,34,704,277,152,0.5487,125,0.4513
38,35,737,292,155,0.5308,137,0.4692
38,36,693,267,168,0.6292,99,0.3708
38,37,709,325,156,0.48,169,0.52
38,38,725,257,154,0.5992,103,0.4008
38,39,755,353,197,0.5581,156,0.4419
38,40,689,307,197,0.6417,110,0.3583
38,41,635,319,204,0.6395,115,0.3605
39,1,604,306,196,0.6405,110,0.3595
39,2,648,405,284,0.7012,121,0.2988
39,3,696,317,194,0.612,123,0.388
39,4,624,319,203,0.6364,116,0.3636
39,5,715,312,161,0.516,151,0.484
39,6,732,287,134,0.4669,153,0.5331
39,7,610,273,128,0.4689,145,0.5311
39,8,789,334,133,0.3982,201,0.6018
39,9,735,302,180,0.596,122,0.404
39,10,330,150,77,0.5133,73,0.4867
39,11,672,271,158,0.583,113,0.417
39,12,938,339,161,0.4749,178,0.5251
39,13,738,279,162,0.5806,117,0.4194
39,14,666,255,152,0.5961,103,0.4039
39,15,769,356,250,0.7022,106,0.2978
39,16,707,223,94,0.4215,129,0.5785
39,17,698,341,191,0.5601,150,0.4399
39,18,729,306,155,0.5065,151,0.4935
39,19,677,307,166,0.5407,141,0.4593
39,20,815,368,244,0.663,124,0.337
39,21,677,300,193,0.6433,107,0.3567
39,22,670,229,95,0.4148,134,0.5852
39,23,703,378,243,0.6429,135,0.3571
39,24,798,417,251,0.6019,166,0.3981
39,25,702,226,114,0.5044,112,0.4956
39,26,680,317,188,0.5931,129,0.4069
39,27,107,72,48,0.6667,24,0.3333
39,28,756,357,193,0.5406,164,0.4594
39,29,430,136,76,0.5588,60,0.4412
39,30,816,328,151,0.4604,177,0.5396
39,31,702,250,117,0.468,133,0.532
39,32,751,308,182,0.5909,126,0.4091
39,33,855,307,177,0.5765,130,0.4235
39,34,775,288,164,0.5694,124,0.4306
39,35,694,305,136,0.4459,169,0.5541
39,36,312,121,83,0.686,38,0.314
39,37,607,351,247,0.7037,104,0.2963
39,38,337,211,155,0.7346,56,0.2654
39,39,416,199,109,0.5477,90,0.4523
39,40,631,269,170,0.632,99,0.368
39,41,709,372,243,0.6532,129,0.3468
39,42,644,359,250,0.6964,109,0.3036
39,43,691,376,240,0.6383,136,0.3617
39,44,522,259,187,0.722,72,0.278
39,45,626,348,236,0.6782,112,0.3218
40,1,710,265,146,0.5509,119,0.4491
40,2,744,284,143,0.5035,141,0.4965
40,3,798,353,187,0.5297,166,0.4703
40,4,525,229,127,0.5546,102,0.4454
40,5,738,329,182,0.5532,147,0.4468
40,6,761,349,148,0.4241,201,0.5759
40,7,624,342,192,0.5614,150,0.4386
40,8,866,365,179,0.4904,186,0.5096
40,9,654,257,161,0.6265,96,0.3735
40,10,895,336,173,0.5149,163,0.4851
40,11,714,341,195,0.5718,146,0.4282
40,12,526,213,128,0.6009,85,0.3991
40,13,816,395,178,0.4506,217,0.5494
40,14,766,255,145,0.5686,110,0.4314
40,15,776,274,155,0.5657,119,0.4343
40,16,778,351,190,0.5413,161,0.4587
40,17,650,297,167,0.5623,130,0.4377
40,18,732,231,99,0.4286,132,0.5714
40,19,949,396,213,0.5379,183,0.4621
40,20,789,276,159,0.5761,117,0.4239
40,21,749,357,202,0.5658,155,0.4342
40,22,681,281,147,0.5231,134,0.4769
40,23,828,380,197,0.5184,183,0.4816
40,24,775,263,142,0.5399,121,0.4601
40,25,755,346,202,0.5838,144,0.4162
40,26,700,346,179,0.5173,167,0.4827
40,27,948,402,184,0.4577,218,0.5423
40,28,720,328,147,0.4482,181,0.5518
40,29,704,356,226,0.6348,130,0.3652
40,30,647,365,253,0.6932,112,0.3068
40,31,724,358,177,0.4944,181,0.5056
40,32,728,365,197,0.5397,168,0.4603
40,33,605,333,168,0.5045,165,0.4955
40,34,703,286,161,0.5629,125,0.4371
40,35,709,210,119,0.5667,91,0.4333
40,36,602,307,183,0.5961,124,0.4039
40,37,758,324,155,0.4784,169,0.5216
40,38,779,376,180,0.4787,196,0.5213
40,39,302,95,42,0.4421,53,0.5579
41,1,671,384,234,0.6094,150,0.3906
41,2,709,442,285,0.6448,157,0.3552
41,3,694,340,193,0.5676,147,0.4324
41,4,696,478,308,0.6444,170,0.3556
41,5,821,428,275,0.6425,153,0.3575
41,6,753,500,372,0.744,128,0.256
41,7,739,470,326,0.6936,144,0.3064
41,8,706,425,255,0.6,170,0.4
41,9,752,391,220,0.5627,171,0.4373
41,10,700,467,320,0.6852,147,0.3148
41,11,802,445,271,0.609,174,0.391
41,12,802,387,238,0.615,149,0.385
41,13,810,444,266,0.5991,178,0.4009
41,14,734,477,352,0.7379,125,0.2621
41,15,869,477,298,0.6247,179,0.3753
41,16,690,373,223,0.5979,150,0.4021
41,17,727,415,284,0.6843,131,0.3157
41,18,658,374,232,0.6203,142,0.3797
41,19,747,438,290,0.6621,148,0.3379
41,20,683,329,218,0.6626,111,0.3374
41,21,755,390,276,0.7077,114,0.2923
41,22,736,426,253,0.5939,173,0.4061
41,23,826,420,281,0.669,139,0.331
41,24,745,369,228,0.6179,141,0.3821
41,25,888,203,117,0.5764,86,0.4236
41,26,677,425,255,0.6,170,0.4
41,27,762,276,184,0.6667,92,0.3333
41,28,885,263,152,0.5779,111,0.4221
41,29,783,214,150,0.7009,64,0.2991
41,30,748,402,236,0.5871,166,0.4129
41,31,753,456,325,0.7127,131,0.2873
41,32,586,314,199,0.6338,115,0.3662
41,33,706,354,213,0.6017,141,0.3983
41,34,645,353,231,0.6544,122,0.3456
41,35,808,457,285,0.6236,172,0.3764
41,36,689,396,242,0.6111,154,0.3889
41,37,790,438,273,0.6233,165,0.3767
41,38,719,349,195,0.5587,154,0.4413
41,39,723,416,275,0.6611,141,0.3389
41,40,743,466,299,0.6416,167,0.3584
41,41,756,428,282,0.6589,146,0.3411
41,42,719,419,269,0.642,150,0.358
41,43,718,413,269,0.6513,144,0.3487
41,44,732,455,321,0.7055,134,0.2945
41,45,697,343,200,0.5831,143,0.4169
41,46,716,446,282,0.6323,164,0.3677
41,47,729,398,255,0.6407,143,0.3593
42,1,719,419,383,0.9141,36,0.0859
42,2,832,262,202,0.771,60,0.229
42,3,729,256,199,0.7773,57,0.2227
42,4,1164,463,388,0.838,75,0.162
42,5,677,251,235,0.9363,16,0.0637
42,6,699,447,341,0.7629,106,0.2371
42,7,866,436,385,0.883,51,0.117
42,8,677,347,289,0.8329,58,0.1671
42,9,895,315,245,0.7778,70,0.2222
42,10,688,287,242,0.8432,45,0.1568
42,11,551,283,226,0.7986,57,0.2014
42,12,629,312,271,0.8686,41,0.1314
42,13,640,430,338,0.786,92,0.214
42,14,787,298,268,0.8993,30,0.1007
42,15,709,234,209,0.8932,25,0.1068
42,16,692,303,238,0.7855,65,0.2145
42,17,849,329,300,0.9119,29,0.0881
42,18,791,248,210,0.8468,38,0.1532
42,19,883,433,393,0.9076,40,0.0924
42,20,728,239,209,0.8745,30,0.1255
42,21,592,247,194,0.7854,53,0.2146
42,22,451,181,167,0.9227,14,0.0773
42,23,781,310,280,0.9032,30,0.0968
42,24,758,371,318,0.8571,53,0.1429
42,25,841,345,289,0.8377,56,0.1623
42,26,788,348,300,0.8621,48,0.1379
42,27,531,294,220,0.7483,74,0.2517
42,28,786,424,333,0.7854,91,0.2146
42,29,759,301,265,0.8804,36,0.1196
42,30,599,369,328,0.8889,41,0.1111
42,31,725,329,293,0.8906,36,0.1094
42,32,775,255,227,0.8902,28,0.1098
42,33,791,312,245,0.7853,67,0.2147
42,34,733,401,369,0.9202,32,0.0798
42,35,986,421,347,0.8242,74,0.1758
42,36,1124,338,285,0.8432,53,0.1568
42,37,594,200,185,0.925,15,0.075
42,38,719,295,264,0.8949,31,0.1051
42,39,846,260,226,0.8692,34,0.1308
42,40,895,320,280,0.875,40,0.125
42,41,757,286,228,0.7972,58,0.2028
42,42,888,346,290,0.8382,56,0.1618
43,1,423,215,166,0.7721,49,0.2279
43,2,708,349,301,0.8625,48,0.1375
43,3,762,411,365,0.8881,46,0.1119
43,4,905,345,310,0.8986,35,0.1014
43,5,598,269,238,0.8848,31,0.1152
43,6,573,253,204,0.8063,49,0.1937
43,7,508,258,208,0.8062,50,0.1938
43,8,620,296,241,0.8142,55,0.1858
43,9,825,434,355,0.818,79,0.182
43,10,853,406,348,0.8571,58,0.1429
43,11,666,287,245,0.8537,42,0.1463
43,12,444,220,187,0.85,33,0.15
43,13,660,317,241,0.7603,76,0.2397
43,14,728,403,364,0.9032,39,0.0968
43,15,747,341,280,0.8211,61,0.1789
43,16,813,321,264,0.8224,57,0.1776
43,17,573,289,255,0.8824,34,0.1176
43,18,748,382,329,0.8613,53,0.1387
43,19,763,385,316,0.8208,69,0.1792
43,20,733,393,307,0.7812,86,0.2188
43,21,768,382,296,0.7749,86,0.2251
43,22,479,205,157,0.7659,48,0.2341
43,23,490,186,151,0.8118,35,0.1882
43,24,609,246,203,0.8252,43,0.1748
43,25,552,307,252,0.8208,55,0.1792
43,26,471,285,248,0.8702,37,0.1298
43,27,599,337,286,0.8487,51,0.1513
43,28,919,428,374,0.8738,54,0.1262
43,29,674,321,244,0.7601,77,0.2399
43,30,930,354,286,0.8079,68,0.1921
43,31,782,391,307,0.7852,84,0.2148
43,32,754,353,298,0.8442,55,0.1558
43,33,793,429,389,0.9068,40,0.0932
43,34,493,276,224,0.8116,52,0.1884
43,35,884,447,399,0.8926,48,0.1074
43,36,392,120,74,0.6167,46,0.3833
43,37,762,284,231,0.8134,53,0.1866
43,38,713,399,373,0.9348,26,0.0652
43,39,661,272,196,0.7206,76,0.2794
43,40,560,194,134,0.6907,60,0.3093
43,41,895,459,379,0.8257,80,0.1743
43,42,708,312,248,0.7949,64,0.2051
43,43,803,461,409,0.8872,52,0.1128
43,44,687,337,288,0.8546,49,0.1454
43,45,447,250,212,0.848,38,0.152
43,46,399,180,153,0.85,27,0.15
44,1,1058,524,388,0.7405,136,0.2595
44,2,760,317,251,0.7918,66,0.2082
44,3,453,320,269,0.8406,51,0.1594
44,4,701,410,334,0.8146,76,0.1854
44,5,713,278,185,0.6655,93,0.3345
44,6,868,311,247,0.7942,64,0.2058
44,7,534,306,256,0.8366,50,0.1634
44,8,874,361,262,0.7258,99,0.2742
44,9,695,272,213,0.7831,59,0.2169
44,10,774,279,226,0.81,53,0.19
44,11,782,301,232,0.7708,69,0.2292
44,12,741,372,281,0.7554,91,0.2446
44,13,636,246,212,0.8618,34,0.1382
44,14,675,268,216,0.806,52,0.194
44,15,696,334,246,0.7365,88,0.2635
44,16,808,336,257,0.7649,79,0.2351
44,17,851,411,314,0.764,97,0.236
44,18,854,314,245,0.7803,69,0.2197
44,19,818,401,289,0.7207,112,0.2793
44,20,695,216,140,0.6481,76,0.3519
44,21,768,298,232,0.7785,66,0.2215
44,22,748,371,287,0.7736,84,0.2264
44,23,673,284,213,0.75,71,0.25
44,24,587,323,243,0.7523,80,0.2477
44,25,688,296,230,0.777,66,0.223
44,26,732,280,202,0.7214,78,0.2786
44,27,777,358,273,0.7626,85,0.2374
44,28,682,320,228,0.7125,92,0.2875
44,29,822,304,225,0.7401,79,0.2599
44,30,790,325,241,0.7415,84,0.2585
44,31,697,243,188,0.7737,55,0.2263
44,32,821,330,244,0.7394,86,0.2606
44,33,631,255,176,0.6902,79,0.3098
44,34,804,364,268,0.7363,96,0.2637
44,35,790,444,355,0.7995,89,0.2005
44,36,706,286,222,0.7762,64,0.2238
44,37,757,339,244,0.7198,95,0.2802
44,38,733,268,212,0.791,56,0.209
44,39,694,278,229,0.8237,49,0.1763
44,40,674,300,230,0.7667,70,0.2333
44,41,817,340,258,0.7588,82,0.2412
45,1,512,261,140,0.5364,121,0.4636
45,2,588,283,151,0.5336,132,0.4664
45,3,539,294,176,0.5986,118,0.4014
45,4,757,408,229,0.5613,179,0.4387
45,5,712,378,236,0.6243,142,0.3757
45,6,802,445,281,0.6315,164,0.3685
45,7,887,484,281,0.5806,203,0.4194
45,8,744,328,164,0.5,164,0.5
45,9,758,330,169,0.5121,161,0.4879
45,10,778,389,188,0.4833,201,0.5167
45,11,589,258,117,0.4535,141,0.5465
45,12,679,320,164,0.5125,156,0.4875
45,13,598,351,193,0.5499,158,0.4501
45,14,941,424,262,0.6179,162,0.3821
45,15,829,470,268,0.5702,202,0.4298
45,16,621,318,194,0.6101,124,0.3899
45,17,788,376,235,0.625,141,0.375
45,18,811,356,209,0.5871,147,0.4129
45,19,433,174,112,0.6437,62,0.3563
45,20,542,221,126,0.5701,95,0.4299
45,21,639,333,206,0.6186,127,0.3814
45,22,690,324,201,0.6204,123,0.3796
45,23,735,360,223,0.6194,137,0.3806
45,24,635,325,192,0.5908,133,0.4092
45,25,442,285,173,0.607,112,0.393
45,26,447,191,113,0.5916,78,0.4084
45,27,691,315,187,0.5937,128,0.4063
45,28,576,274,167,0.6095,107,0.3905
45,29,524,226,141,0.6239,85,0.3761
45,30,654,305,183,0.6,122,0.4
45,31,569,289,182,0.6298,107,0.3702
45,32,674,321,187,0.5826,134,0.4174
45,33,487,236,150,0.6356,86,0.3644
45,34,766,369,220,0.5962,149,0.4038
45,35,731,422,257,0.609,165,0.391
45,36,723,400,240,0.6,160,0.4
45,37,687,325,201,0.6185,124,0.3815
45,38,708,288,173,0.6007,115,0.3993
45,39,733,324,197,0.608,127,0.392
45,40,693,363,238,0.6556,125,0.3444
45,41,659,339,207,0.6106,132,0.3894
45,42,674,399,254,0.6366,145,0.3634
45,43,722,427,250,0.5855,177,0.4145
45,44,685,378,245,0.6481,133,0.3519
45,45,512,243,140,0.5761,103,0.4239
45,46,542,263,158,0.6008,105,0.3992
45,47,534,284,164,0.5775,120,0.4225
45,48,609,292,197,0.6747,95,0.3253
46,1,738,311,174,0.5595,137,0.4405
46,2,696,329,207,0.6292,122,0.3708
46,3,764,457,353,0.7724,104,0.2276
46,4,725,367,235,0.6403,132,0.3597
46,5,827,297,221,0.7441,76,0.2559
46,6,696,315,184,0.5841,131,0.4159
46,7,770,492,352,0.7154,140,0.2846
46,8,736,282,149,0.5284,133,0.4716
46,9,695,324,218,0.6728,106,0.3272
46,10,941,329,233,0.7082,96,0.2918
46,11,767,322,218,0.677,104,0.323
46,12,642,318,177,0.5566,141,0.4434
46,13,707,317,218,0.6877,99,0.3123
46,14,922,428,217,0.507,211,0.493
46,15,731,347,252,0.7262,95,0.2738
46,16,744,357,201,0.563,156,0.437
46,17,812,432,310,0.7176,122,0.2824
46,18,755,311,219,0.7042,92,0.2958
46,19,457,263,198,0.7529,65,0.2471
46,20,865,351,200,0.5698,151,0.4302
46,21,709,226,135,0.5973,91,0.4027
46,22,674,289,115,0.3979,174,0.6021
46,23,761,284,175,0.6162,109,0.3838
46,24,727,376,283,0.7527,93,0.2473
46,25,754,350,185,0.5286,165,0.4714
46,26,688,280,166,0.5929,114,0.4071
46,27,773,329,213,0.6474,116,0.3526
46,28,671,421,309,0.734,112,0.266
46,29,657,304,208,0.6842,96,0.3158
46,30,685,334,191,0.5719,143,0.4281
46,31,667,292,197,0.6747,95,0.3253
46,32,877,416,214,0.5144,202,0.4856
46,33,737,358,283,0.7905,75,0.2095
46,34,827,346,221,0.6387,125,0.3613
46,35,884,410,266,0.6488,144,0.3512
46,36,660,364,273,0.75,91,0.25
46,37,545,247,159,0.6437,88,0.3563
46,38,773,299,180,0.602,119,0.398
46,39,681,316,249,0.788,67,0.212
46,40,609,297,165,0.5556,132,0.4444
47,1,463,191,133,0.6963,58,0.3037
47,2,780,418,290,0.6938,128,0.3062
47,3,742,460,352,0.7652,108,0.2348
47,4,785,398,272,0.6834,126,0.3166
47,5,760,340,222,0.6529,118,0.3471
47,6,808,326,237,0.727,89,0.273
47,7,683,304,183,0.602,121,0.398
47,8,734,400,291,0.7275,109,0.2725
47,9,617,260,160,0.6154,100,0.3846
47,10,821,336,190,0.5655,146,0.4345
47,11,734,276,210,0.7609,66,0.2391
47,12,707,360,221,0.6139,139,0.3861
47,13,686,328,178,0.5427,150,0.4573
47,14,648,321,218,0.6791,103,0.3209
47,15,780,350,142,0.4057,208,0.5943
47,16,722,383,235,0.6136,148,0.3864
47,17,711,317,201,0.6341,116,0.3659
47,18,698,345,251,0.7275,94,0.2725
47,19,844,357,185,0.5182,172,0.4818
47,20,662,355,202,0.569,153,0.431
47,21,660,301,181,0.6013,120,0.3987
47,22,721,386,229,0.5933,157,0.4067
47,23,747,357,179,0.5014,178,0.4986
47,24,641,307,204,0.6645,103,0.3355
47,25,759,345,222,0.6435,123,0.3565
47,26,794,360,193,0.5361,167,0.4639
47,27,647,282,184,0.6525,98,0.3475
47,28,690,351,217,0.6182,134,0.3818
47,29,740,333,223,0.6697,110,0.3303
47,30,816,351,202,0.5755,149,0.4245
47,31,739,317,161,0.5079,156,0.4921
47,32,757,357,199,0.5574,158,0.4426
47,33,688,343,272,0.793,71,0.207
47,34,725,403,253,0.6278,150,0.3722
47,35,698,318,221,0.695,97,0.305
47,36,722,359,207,0.5766,152,0.4234
47,37,742,361,223,0.6177,138,0.3823
47,38,683,318,201,0.6321,117,0.3679
47,39,703,370,252,0.6811,118,0.3189
47,40,655,372,229,0.6156,143,0.3844
47,41,776,401,246,0.6135,155,0.3865
47,42,654,289,133,0.4602,156,0.5398
47,43,703,305,213,0.6984,92,0.3016
47,44,746,355,267,0.7521,88,0.2479
47,45,658,359,215,0.5989,144,0.4011
47,46,687,329,197,0.5988,132,0.4012
47,47,792,344,231,0.6715,113,0.3285
47,48,79,51,42,0.8235,9,0.1765
48,1,635,300,149,0.4967,151,0.5033
48,2,330,203,142,0.6995,61,0.3005
48,3,830,328,179,0.5457,149,0.4543
48,4,568,301,187,0.6213,114,0.3787
48,5,383,250,160,0.64,90,0.36
48,6,805,348,215,0.6178,133,0.3822
48,7,689,333,184,0.5526,149,0.4474
48,8,408,276,184,0.6667,92,0.3333
48,9,492,275,187,0.68,88,0.32
48,10,862,427,225,0.5269,202,0.4731
48,11,566,303,179,0.5908,124,0.4092
48,12,824,371,229,0.6173,142,0.3827
48,13,880,470,313,0.666,157,0.334
48,14,403,228,160,0.7018,68,0.2982
48,15,503,207,128,0.6184,79,0.3816
48,16,809,302,156,0.5166,146,0.4834
48,17,643,326,188,0.5767,138,0.4233
48,18,662,314,213,0.6783,101,0.3217
48,19,518,260,156,0.6,104,0.4
48,20,764,369,175,0.4743,194,0.5257
48,21,949,378,219,0.5794,159,0.4206
48,22,571,372,253,0.6801,119,0.3199
48,23,783,461,280,0.6074,181,0.3926
48,24,847,345,205,0.5942,140,0.4058
48,25,584,345,201,0.5826,144,0.4174
48,26,411,184,112,0.6087,72,0.3913
48,27,1158,276,151,0.5471,125,0.4529
48,28,911,423,293,0.6927,130,0.3073
48,29,362,233,184,0.7897,49,0.2103
48,30,561,292,153,0.524,139,0.476
48,31,1045,359,183,0.5097,176,0.4903
48,32,647,258,125,0.4845,133,0.5155
48,33,372,253,194,0.7668,59,0.2332
48,34,598,308,162,0.526,146,0.474
48,35,785,274,184,0.6715,90,0.3285
48,36,393,265,180,0.6792,85,0.3208
48,37,738,306,137,0.4477,169,0.5523
48,38,658,390,250,0.641,140,0.359
48,39,598,317,205,0.6467,112,0.3533
48,40,561,287,143,0.4983,144,0.5017
48,41,830,296,150,0.5068,146,0.4932
48,42,770,327,160,0.4893,167,0.5107
48,43,813,357,209,0.5854,148,0.4146
48,44,784,366,197,0.5383,169,0.4617
48,45,501,220,111,0.5045,109,0.4955
48,46,475,243,153,0.6296,90,0.3704
49,1,672,189,102,0.5397,87,0.4603
49,2,479,220,111,0.5045,109,0.4955
49,3,892,361,168,0.4654,193,0.5346
49,4,889,355,147,0.4141,208,0.5859
49,5,801,368,203,0.5516,165,0.4484
49,6,670,264,122,0.4621,142,0.5379
49,7,638,288,148,0.5139,140,0.4861
49,8,654,266,143,0.5376,123,0.4624
49,9,727,311,147,0.4727,164,0.5273
49,10,729,347,153,0.4409,194,0.5591
49,11,848,380,175,0.4605,205,0.5395
49,12,894,398,177,0.4447,221,0.5553
49,13,818,405,194,0.479,211,0.521
49,14,736,306,177,0.5784,129,0.4216
49,15,616,228,107,0.4693,121,0.5307
49,16,800,350,204,0.5829,146,0.4171
49,17,580,277,153,0.5523,124,0.4477
49,18,902,420,178,0.4238,242,0.5762
49,19,755,272,134,0.4926,138,0.5074
49,20,1019,456,200,0.4386,256,0.5614
49,21,557,225,125,0.5556,100,0.4444
49,22,843,368,168,0.4565,200,0.5435
49,23,857,324,131,0.4043,193,0.5957
49,24,791,252,132,0.5238,120,0.4762
49,25,877,376,174,0.4628,202,0.5372
49,26,868,384,193,0.5026,191,0.4974
49,27,890,335,141,0.4209,194,0.5791
49,28,911,338,149,0.4408,189,0.5592
49,29,825,352,152,0.4318,200,0.5682
49,30,851,322,154,0.4783,168,0.5217
49,31,606,256,160,0.625,96,0.375
49,32,836,325,180,0.5538,145,0.4462
49,33,719,280,125,0.4464,155,0.5536
50,1,656,323,245,0.7585,78,0.2415
50,2,478,180,117,0.65,63,0.35
50,3,597,279,194,0.6953,85,0.3047
50,4,765,316,182,0.5759,134,0.4241
50,5,565,264,192,0.7273,72,0.2727
50,6,831,311,172,0.5531,139,0.4469
50,7,720,369,194,0.5257,175,0.4743
50,8,673,263,134,0.5095,129,0.4905
50,9,647,248,132,0.5323,116,0.4677
50,10,834,317,220,0.694,97,0.306
50,11,518,252,207,0.8214,45,0.1786
50,12,272,158,134,0.8481,24,0.1519
50,13,929,243,99,0.4074,144,0.5926
50,14,197,106,81,0.7642,25,0.2358
50,15,677,365,204,0.5589,161,0.4411
50,16,205,123,97,0.7886,26,0.2114
50,17,780,226,134,0.5929,92,0.4071
50,18,142,88,82,0.9318,6,0.0682
50,19,593,200,71,0.355,129,0.645
50,20,717,318,129,0.4057,189,0.5943
50,21,586,234,120,0.5128,114,0.4872
50,22,705,249,169,0.6787,80,0.3213
50,23,608,241,158,0.6556,83,0.3444
50,24,731,320,246,0.7688,74,0.2313
50,25,757,320,239,0.7469,81,0.2531
50,26,867,272,131,0.4816,141,0.5184
50,27,182,88,73,0.8295,15,0.1705
50,28,844,313,154,0.492,159,0.508
50,29,742,218,91,0.4174,127,0.5826
50,30,579,209,106,0.5072,103,0.4928
50,31,932,286,131,0.458,155,0.542
50,32,866,256,123,0.4805,133,0.5195
50,33,543,282,224,0.7943,58,0.2057
50,34,822,386,235,0.6088,151,0.3912
50,35,740,329,167,0.5076,162,0.4924
50,36,653,281,148,0.5267,133,0.4733
50,37,616,281,159,0.5658,122,0.4342
50,38,265,170,131,0.7706,39,0.2294
50,39,602,209,146,0.6986,63,0.3014
50,40,781,368,278,0.7554,90,0.2446
